effusive	effusion @@ive
sloppy	slop @@y
internalization	internalize @@ation
microscopically	microscopic @@ally
chum	chum
insupportable	in @@supportable
besiege	be @@siege
quarterly	quarter @@ly
unconsciousness	unconscious @@ness
frightfully	frightful @@ly
expectantly	expectant @@ly
controversialist	controversialism @@ist
miffed	miffed
harmoniously	harmonious @@ly
western	western
cracksman	crack @@s @@man
minute	minute
archdeaconry	archdeacon @@ry
profitably	profitable @@ly
loyalty	loyal @@ty
dalesman	dale @@s @@man
deflection	deflect @@ion
cull	cull
axiomatically	axiomatic @@ally
empty	empty
benzol	benzol
foremost	fore @@most
lettuce	lettuce
ace	ace
sericultural	sericulture @@al
crest	crest
echo	echo
porcelain	porcelain
shriek	shriek
bifurcate	bifurcate
intermix	inter @@mix
preoccupied	preoccupied
bygone	bygone
laconism	laconic @@ism
metal	metal
lean	lean
hotly	hot @@ly
temptation	tempt @@ation
forge	forge
plaintively	plaintive @@ly
replaceable	replace @@able
sartorially	sartorial @@ly
lute	lute
straitened	straitened
corroborative	corroboration @@ive
deed	deed
relish	relish
onerously	onerous @@ly
demon	demon
seventeenth	seventeenth
sofa	sofa
reason	reason
argue	argue
cancerous	cancer @@ous
sagely	sage @@ly
sequencing	sequence @@ing
brainy	brain @@y
borrower	borrow @@er
ghoul	ghoul
lathi	lathi
numb	numb
regularization	regularize @@ation
pure	pure
cleanliness	cleanly @@ness
defeatism	defeat @@ism
fated	fate @@ed
bulgy	bulge @@y
whorl	whorl
giver	give @@er
revitalization	revitalize @@ation
wealthy	wealth @@y
brilliantly	brilliant @@ly
dialectics	dialectic @@s
triumphal	triumph @@al
thirdly	third @@ly
lyrical	lyric @@al
concentrate	concentrate
fez	fez
underline	under @@line
atheist	atheism @@ist
priest	priest
snappishly	snappish @@ly
valetudinarian	valetudinarian
fieriness	fiery @@ness
specifically	specific @@ally
ineffectually	ineffectual @@ly
eclectically	eclectic @@ally
bald	bald
prepared	prepared
daily	daily
merchant	merchant
teal	teal
testatrix	testatrix
ablative	ablative
hornet	hornet
frequently	frequent @@ly
courageously	courageous @@ly
directness	direct @@ness
bonus	bonus
bloodlessness	bloodless @@ness
independently	independent @@ly
blusterer	bluster @@er
transplant	transplant
wan	wan
wastage	waste @@age
programme	programme
turning	turning
killer	kill @@er
chastely	chaste @@ly
armless	arm @@less
fallibility	fallible @@ity
formulaic	formula @@ic
revival	revive @@al
counterattack	counterattack
remedy	remedy
doggy	dog @@y
embezzler	embezzle @@er
dearest	dearest
dozily	dozy @@ly
lyrically	lyrical @@ly
propellant	propellant
loathe	loath
selectively	selective @@ly
chestnut	chestnut
bedevil	be @@devil
outdoors	out @@doors
disloyalty	disloyal @@ty
confide	confide
hip	hip
berry	berry
can	can
soppy	sop @@y
nervous	nerve @@ous
holder	hold @@er
chow	chow
honour	honour
hobble	hobble
loathing	loathing
raggedness	ragged @@ness
cunning	cunning
rerun	rerun
dope	dope
arithmetician	arithmetic @@ian
sociability	sociable @@ity
garage	garage
inopportuneness	inopportune @@ness
mistakenly	mistaken @@ly
sonant	sonant
muted	muted
reek	reek
briefing	briefing
fermentation	ferment @@ation
sorcerer	sorcery @@er
porcine	pork @@ine
codicil	codicil
storyteller	story @@tell @@er
sweetly	sweet @@ly
misstate	mis @@state
chorus	chorus
synthetic	synthesis @@ic
sensuousness	sensuous @@ness
stony	stone @@y
licence	license
undernourish	under @@nourish
inexcusably	inexcusable @@ly
legislatively	legislative @@ly
psychosomatically	psychosomatic @@ally
invitingly	inviting @@ly
meteor	meteor
teat	teat
sisterhood	sister @@hood
playgoer	play @@go @@er
dolorously	dolorous @@ly
reduplicate	re @@duplicate
overweight	over @@weight
professional	profession @@al
representation	represent @@ation
tear	tear
thrillingly	thrilling @@ly
dizzily	dizzy @@ly
quire	quire
once	once
machine	machine
address	address
trustee	trust @@ee
mentally	mental @@ly
prohibition	prohibit @@ion
becalmed	be @@calm @@ed
ensanguined	ensanguined
doctor	doctor
remorsefulness	remorseful @@ness
congruently	congruent @@ly
dungaree	dungaree
expectant	expect @@ant
premaritally	premarital @@ly
repair	repair
compacted	compact @@ed
ownership	owner @@ship
shame	shame
inadvertently	inadvertent @@ly
encamp	en @@camp
disreputable	disrepute @@able
rusticate	rustic @@ate
detergent	detergent
event	event
cahoots	cahoots
palmetto	palmetto
distiller	distil @@er
ethnographically	ethnographic @@ally
environmental	environment @@al
habit	habit
otiose	otiose
manila	Manila
repairable	repair @@able
roofless	roof @@less
boys	boys
noiseless	noise @@less
whelp	whelp
comprehensibility	comprehensible @@ity
conciliatory	conciliation @@ory
untinged	un @@tinged
haven	haven
gloomily	gloomy @@ly
radically	radical @@ly
sulphuretted	sulphuretted
abdication	abdicate @@ion
perpetually	perpetual @@ly
hellishly	hellish @@ly
roguishly	roguish @@ly
compartmentalize	compartmental @@ize
meaningless	meaning @@less
control	control
thither	thither
scruple	scruple
courageous	courage @@ous
parity	par @@ity
reeducate	re @@educate
tale	tale
earful	ear @@ful
longwise	long @@wise
hearse	hearse
lateral	lateral
absentee	absent @@ee
trainable	train @@able
overlap	over @@lap
imperative	imperative
onerousness	onerous @@ness
trundle	trundle
disruptive	disruption @@ive
mummification	mummify @@ation
healing	healing
fluidity	fluid @@ity
professionalism	professional @@ism
cussed	cussed
regnant	reign @@ant
signal	signal
indivisibility	indivisible @@ity
victoriously	victorious @@ly
bicycle	bicycle
buttery	butt @@ery
bottle	bottle
sponginess	spongy @@ness
dashed	dashed
rib	rib
pearly	pearl @@y
snout	snout
stateside	stateside
cloddish	clod @@ish
repentantly	repentant @@ly
pitiful	pity @@ful
dinosaur	dinosaur
fixedly	fixed @@ly
blouse	blouse
extermination	exterminate @@ion
horridness	horrid @@ness
jackdaw	jackdaw
turf	turf
fruit	fruit
abstinence	abstinent @@ence
sago	sago
genitally	genital @@ly
criminal	crime @@al
sleuth	sleuth
dent	dent
lissomly	lissom @@ly
anticlockwise	anticlockwise
dimness	dim @@ness
dressing	dressing
hazily	hazy @@ly
communism	commune @@ism
angularity	angular @@ity
unnatural	un @@natural
deckle	deckle
eleventh	eleventh
tumultuous	tumult @@ous
intelligibility	intelligible @@ity
originator	originate @@or
competence	competent @@ence
electoral	elector @@al
horribly	horrible @@ly
anomalously	anomalous @@ly
modishly	modish @@ly
reform	reform
vulnerability	vulnerable @@ity
disregard	disregard
heavyhearted	heavy @@heart @@ed
malign	malign
familiarly	familiar @@ly
prickly	prickle @@y
unknown	un @@known
stridence	strident @@ence
giro	giro
realistically	realistic @@ally
bridal	bride @@al
lusciousness	luscious @@ness
ozone	ozone
miscellaneousness	miscellaneous @@ness
helping	helping
unprecedentedly	unprecedented @@ly
alertness	alert @@ness
fifteenth	fifteenth
disoblige	dis @@oblige
redundantly	redundant @@ly
plunderer	plunder @@er
minimize	minimal @@ize
devil	devil
dacha	dacha
mouth	mouth
morphine	morphia @@ine
domiciliary	domicile @@ary
powered	power @@ed
hymen	hymen
misspelling	misspelling
invidiously	invidious @@ly
ideologist	ideology @@ist
staggering	staggering
repentant	repent @@ant
cogently	cogent @@ly
bright	bright
limpness	limp @@ness
slangily	slangy @@ly
winnings	winning @@s
indefeasible	in @@defeasible
mists	mists
pinkish	pink @@ish
footslogging	footslogging
ramekin	ramekin
eunuch	eunuch
inconsequentiality	inconsequential @@ity
defoliation	defoliate @@ion
verbena	verbena
canary	canary
mesmerize	mesmerism @@ize
irritable	irritate @@able
bonded	bonded
shelter	shelter
undertow	under @@tow
week	week
nativity	native @@ity
slim	slim
exultant	exult @@ant
unremittingly	unremitting @@ly
haunch	haunch
pimple	pimple
downwind	downwind
realizable	realize @@able
higher	higher
codling	codling
inlay	inlay
bubble	bubble
mendaciously	mendacious @@ly
aimlessly	aimless @@ly
amorphously	amorphous @@ly
strategically	strategic @@ally
miscall	mis @@call
wimple	wimple
materialist	materialism @@ist
sweeping	sweeping
large	large
inflammatory	inflammation @@ory
premonition	pre @@monition
philanthropical	philanthropy @@ical
llama	llama
twelve	twelve
gesture	gesture
noddle	noddle
prefix	pre @@fix
nippers	nip @@er @@s
formlessness	formless @@ness
republicanism	republican @@ism
unemployable	un @@employable
wrest	wrest
demystification	demystify @@ation
suggestive	suggestion @@ive
photostat	Photostat
promulgator	promulgate @@or
curiosity	curious @@ity
limy	lime @@y
progression	progress @@ion
remarkable	remark @@able
outride	out @@ride
amorphous	a @@morph @@ous
infinitive	infinitive
drain	drain
refutable	refute @@able
ride	ride
heck	heck
pawkiness	pawky @@ness
politely	polite @@ly
vault	vault
langur	langur
supervisor	supervise @@or
borstal	borstal
mono	mono
disagree	dis @@agree
bistro	bistro
teacher	teach @@er
abusively	abusive @@ly
extrication	extricate @@ion
soloist	solo @@ist
blankness	blank @@ness
whitening	whitening
endearingly	endearing @@ly
particularity	particular @@ity
tip	tip
tragical	tragedy @@ical
inharmoniousness	inharmonious @@ness
delve	delve
badger	badger
freeholder	freehold @@er
recalcitrant	recalcitrant
reign	reign
giggle	giggle
irreproachably	irreproachable @@ly
thirtieth	thirtieth
boodle	boodle
unbelieving	un @@believing
contumaciously	contumacious @@ly
sperm	sperm
twitterer	twitter @@er
transpiration	transpire @@ation
praiseworthily	praiseworthy @@ly
rate	rate
heedfully	heedful @@ly
ruby	ruby
mousiness	mousy @@ness
chap	chap
objurgation	objurgate @@ion
tall	tall
maundy	maundy
exiguously	exiguous @@ly
multitudinously	multitudinous @@ly
batter	bat @@er
cuneiform	cuneiform
angostura	angostura
bestir	be @@stir
hitchhiker	hitchhike @@er
unaware	un @@aware
sternwheeler	stern @@wheel @@er
sheepish	sheep @@ish
tonality	tonal @@ity
adolescent	adolescent
creativeness	creative @@ness
pretence	pretend @@ence
freethinker	free @@thinker
ambassadorial	ambassador @@ial
ulna	ulna
dissimilar	dis @@similar
irreverence	irreverent @@ence
squeaker	squeak @@er
guillotine	guillotine
shaggily	shaggy @@ly
amateurishness	amateurish @@ness
ineffaceable	in @@efface @@able
diacritic	diacritic
unasked	un @@asked
bloodily	bloody @@ly
invaluable	in @@valuable
personable	person @@able
sash	sash
binding	binding
telephotographic	telephotography @@ic
discipleship	disciple @@ship
commutable	commute @@able
abnormally	abnormal @@ly
prosperity	prosperous @@ity
likeness	like @@ness
remodel	re @@model
supercargo	super @@cargo
motor	motor
triplet	triple @@let
oversell	over @@sell
symmetrical	symmetry @@ical
valorous	valour @@ous
march	march
pastry	pastry
appellant	appeal @@ant
compel	compel
puce	puce
indescribable	in @@describable
counterfeit	counterfeit
smuggler	smuggle @@er
disarm	dis @@arm
sinew	sinew
facilities	facilities
think	think
sombre	sombre
rower	row @@er
initiation	initiate @@ion
demonetize	de @@monetize
rock	rock
gibe	gibe
cad	cad
spaciousness	spacious @@ness
falsification	falsify @@ation
stated	stated
ripely	ripe @@ly
calculating	calculating
humane	humane
duet	duet
legatee	legate @@ee
somnolently	somnolent @@ly
pestle	pestle
fussiness	fussy @@ness
exploitation	exploit @@ation
sampan	sampan
meanderingly	meandering @@ly
professorial	professor @@ial
retentiveness	retentive @@ness
boxing	boxing
piteously	piteous @@ly
biff	biff
how	how
conceal	conceal
hierarchically	hierarchical @@ly
either	either
subject	subject
illustriously	illustrious @@ly
lilt	lilt
unconventional	un @@conventional
stutterer	stutter @@er
sociably	sociable @@ly
unsexed	unsexed
privileged	privilege @@ed
power	power
psephologist	psephology @@ist
sacrifice	sacrifice
alkali	alkali
feminist	feminist
undercarriage	under @@carriage
volitional	volition @@al
harlot	harlot
improperly	improper @@ly
pope	pope
shutter	shut @@er
batch	batch
integrated	integrated
crooner	croon @@er
sincere	sincere
furiousness	furious @@ness
propitiously	propitious @@ly
limitable	limit @@able
clever	clever
liqueur	liqueur
unionization	unionize @@ation
forefoot	fore @@foot
actinic	actinism @@ic
serenade	serenade
jocund	jocund
shaker	shake @@er
excision	excise @@ion
inedible	in @@edible
reforestation	reforest @@ation
consecutively	consecutive @@ly
gybe	gybe
cleanser	cleanse @@er
emphysema	emphysema
malleability	malleable @@ity
beriberi	beriberi
rethink	re @@think
gelatin	gelatin
vary	vary
hereabouts	here @@about @@s
fay	fay
occasional	occasion @@al
swine	swine
paunchy	paunch @@y
colonizer	colonize @@er
uncommon	un @@common
meliorism	meliorate @@ism
rancidity	rancid @@ity
planless	plan @@less
hatching	hatching
sadism	Sade @@ism
solemnly	solemn @@ly
grower	grow @@er
premier	premier
voluptuousness	voluptuous @@ness
debauch	debauch
mummify	mummy @@ify
ninety	nine @@ty
final	final
aesthetics	aesthetic @@s
imam	imam
lavender	lavender
rewards	rewards
misfire	misfire
burglarize	burglar @@ize
vain	vain
armlet	arm @@let
timelessly	timeless @@ly
combinations	combinations
eligibility	eligible @@ity
blow	blow
forepart	fore @@part
ropey	rope @@y
extravagantly	extravagant @@ly
ethyl	ethyl
stupefaction	stupefy @@ion
vestige	vestige
maximal	maximum @@al
medically	medical @@ly
seminal	semen @@al
specialize	special @@ize
calyx	calyx
driver	drive @@er
assignation	assign @@ation
ingeniously	ingenious @@ly
races	races
augur	augur
effeminacy	effeminate @@cy
reserve	reserve
plum	plum
rescuer	rescue @@er
hyphen	hyphen
interrelationship	interrelation @@ship
expertly	expert @@ly
piggishness	piggish @@ness
formlessly	formless @@ly
wish	wish
misguidedly	misguided @@ly
ranee	ranee
animal	animal
monotheistic	monotheism @@ic
unwieldy	un @@wield @@y
pestilential	pestilence @@ial
tan	tan
speech	speech
days	days
circa	circa
occasionally	occasional @@ly
blameless	blame @@less
incorrectly	incorrect @@ly
zebu	zebu
paraplegic	paraplegia @@ic
vibrancy	vibrant @@ancy
accumulator	accumulate @@or
gall	gall
crossbred	crossbred
perceptiveness	perceptive @@ness
negotiator	negotiate @@or
ragged	rag @@ed
section	section
fairish	fair @@ish
proprietary	proprietor @@ary
forestall	fore @@stall
tempest	tempest
underbid	under @@bid
flee	flee
reliability	reliable @@ity
warden	warden
torque	torque
winsomeness	winsome @@ness
iamb	iamb
benignantly	benignant @@ly
class	class
emigrant	emigrate @@ant
tangle	tangle
lilliputian	Lilliputian
capaciously	capacious @@ly
indelicately	indelicate @@ly
outspokenly	outspoken @@ly
respectably	respectable @@ly
punishing	punishing
draughts	draughts
blandness	bland @@ness
prude	prude
baptize	baptism @@ize
bronchitic	bronchia @@ic
wiriness	wiry @@ness
libellous	libel @@ous
expressionist	expressionism @@ist
hollowly	hollow @@ly
tally	tally
reissue	re @@issue
suppliant	suppliant
adventure	adventure
zealousness	zealous @@ness
indulgence	indulgent @@ence
plumb	plumb
degeneratively	degenerative @@ly
sociologist	sociology @@ist
faddish	fad @@ish
journalist	journalism @@ist
pockmarked	pockmark @@ed
overflow	overflow
vilification	vilify @@ation
doctrinaire	doctrinaire
impetuosity	impetuous @@ity
voluble	voluble
irresolution	irresolute @@ion
found	found
climactic	climax @@ic
maxi	maximum
itemize	item @@ize
titan	titan
drinking	drinking
vaccine	vaccine
parodist	parody @@ist
muchness	much @@ness
drawing	drawing
diagrammatical	diagram @@ical
scratch	scratch
rooms	rooms
venison	venison
reliquary	relic @@ary
toothy	tooth @@y
scurrilously	scurrilous @@ly
bereft	bereft
coagulant	coagulate @@ant
feint	feint
phagocyte	phagocyte
crave	crave
copy	copy
tattered	tatter @@ed
magnificence	magnificent @@ence
thoughtful	thought @@ful
peep	peep
abstainer	abstain @@er
frightened	frightened
tiara	tiara
colourful	colour @@ful
rich	rich
progressively	progressive @@ly
snowball	snowball
cheque	cheque
clerk	clerk
floater	float @@er
pyorrhoea	pyorrhoea
enplane	en @@plane
standoffishness	standoffish @@ness
foreigner	foreign @@er
unroll	un @@roll
chronicle	chronicle
operational	operation @@al
thrift	thrift
faithlessness	faithless @@ness
burp	burp
yawl	yawl
compo	composition
contentiously	contentious @@ly
longitudinal	longitude @@al
mistiness	misty @@ness
magnification	magnify @@ation
analytical	analysis @@ical
pixie	pixie
seducer	seduce @@er
asparagus	asparagus
siesta	siesta
queue	queue
cardigan	cardigan
remand	remand
symbolically	symbolic @@ally
untimely	un @@timely
hesitantly	hesitant @@ly
bruise	bruise
tastefulness	tasteful @@ness
providential	providence @@ial
into	in @@to
selfishness	selfish @@ness
meanie	mean @@ie
base	base
insulator	insulate @@or
chatter	chat @@er
herbage	herb @@age
relic	relic
creakiness	creaky @@ness
insatiably	insatiable @@ly
sacredly	sacred @@ly
nauseousness	nauseous @@ness
exhaust	exhaust
distribution	distribute @@ion
balloon	balloon
filtrate	filtrate
modernist	modernist
ringside	ringside
ibex	ibex
miller	mill @@er
stationery	stationer @@ery
sourness	sour @@ness
causation	cause @@ation
peek	peek
captiously	captious @@ly
jive	jive
igloo	igloo
integral	integer @@al
whiff	whiff
commemorative	commemoration @@ive
movable	movable
shallowly	shallow @@ly
stranded	stranded
undistinguished	un @@distinguished
undulation	undulate @@ion
arthritic	arthritic
busker	busk @@er
relevantly	relevant @@ly
choicely	choice @@ly
prospective	prospect @@ive
pyramid	pyramid
calla	calla
cavalierly	cavalier @@ly
centennial	centennial
inauguration	inaugurate @@ion
canonize	canon @@ize
nigh	nigh
campus	campus
stare	stare
phonics	phonic @@s
gingerly	gingerly
troublesome	trouble @@some
treasonous	treason @@ous
immense	immense
link	link
stakes	stakes
galosh	galosh
subconscious	sub @@conscious
spry	spry
inferiority	inferior @@ity
side	side
inconsequentially	inconsequential @@ly
data	data
concubinage	concubine @@age
immobilization	immobilize @@ation
wardress	warder @@ess
colloquial	colloquy @@al
entomb	en @@tomb
audit	audit
loamy	loam @@y
bareheaded	bare @@head @@ed
overprint	overprint
parr	parr
impressionist	impressionism @@ist
struggle	struggle
appraisal	appraise @@al
stutteringly	stuttering @@ly
fatalistic	fatalist @@ic
eat	eat
seigneur	seigneur
offshore	offshore
undercut	under @@cut
bate	bate
menthol	menthol
spectral	spectre @@al
magnificently	magnificent @@ly
mayhem	mayhem
moistness	moist @@ness
enforceable	enforce @@able
intolerantly	intolerant @@ly
channel	channel
uneconomical	un @@economical
elusiveness	elusive @@ness
weight	weight
village	village
fichu	fichu
passionateness	passionate @@ness
papadum	papadum
coax	coax
reef	reef
groggily	groggy @@ly
punt	punt
recruit	recruit
reafforestation	reafforest @@ation
trifle	trifle
pedestal	pedestal
transcendentalism	transcendental @@ism
lengthen	length @@en
distillation	distil @@ation
understudy	understudy
chivy	chivy
promptness	prompt @@ness
inexpressibly	inexpressible @@ly
anthem	anthem
thrall	thrall
bitumen	bitumen
unwed	un @@wed
commensurably	commensurable @@ly
constructor	construct @@or
navigable	navigate @@able
rhapsody	rhapsody
synthesizer	synthesize @@er
extraction	extract @@ion
corroboration	corroborate @@ion
bole	bole
sloshed	sloshed
shitty	shit @@y
corker	cork @@er
engineer	engineer
sighting	sighting
authoritarianism	authoritarian @@ism
any	any
protuberant	protuberate @@ant
eternity	eternal @@ity
communicable	communicate @@able
unalloyed	un @@alloyed
breeding	breeding
alchemist	alchemy @@ist
tropically	tropical @@ly
swagger	swagger
genre	genre
cabin	cabin
enwrap	en @@wrap
inflamed	inflamed
piteousness	piteous @@ness
eight	eight
compatibly	compatible @@ly
glowing	glowing
supremacist	supremacy @@ist
popery	pope @@ery
brew	brew
overlay	over @@lay
tack	tack
gauzy	gauze @@y
sad	sad
moreover	more @@over
eft	eft
disagreeably	disagreeable @@ly
breakage	break @@age
noble	noble
theatrically	theatrical @@ly
umber	umber
inkily	inky @@ly
verdancy	verdant @@ancy
rockiness	rocky @@ness
impress	impress
pandemic	pandemic
hint	hint
urbanely	urbane @@ly
coddle	coddle
garble	garble
fond	fond
weirdness	weird @@ness
surfing	surfing
mulishness	mulish @@ness
airs	airs
cerebrally	cerebral @@ly
private	private
bine	bine
foulness	foul @@ness
inspiration	inspire @@ation
willingly	willing @@ly
gainings	gaining @@s
carillon	carillon
snarl	snarl
insubordination	insubordinate @@ion
governing	governing
living	living
planner	plan @@er
disharmonious	disharmony @@ous
tights	tight @@s
flue	flue
rarity	rare @@ity
pending	pending
toddle	toddle
digression	digress @@ion
planet	planet
resourcefully	resourceful @@ly
clubbable	club @@able
transcendently	transcendent @@ly
quotable	quote @@able
patchouli	patchouli
poove	poove
forfeit	forfeit
radioactively	radioactive @@ly
charismatic	charisma @@ic
luff	luff
skill	skill
sorrowful	sorrow @@ful
packed	packed
creativity	creative @@ity
ignition	ignite @@ion
parachute	parachute
inversion	invert @@ion
retire	retire
sandbag	sandbag
withdrawn	withdrawn
shaky	shake @@y
informant	inform @@ant
opal	opal
detention	detain @@ion
uneducated	un @@educated
bespoke	bespoke
nonconformity	non @@conformity
convolute	convolute
prowess	prowess
grizzled	grizzled
diffraction	diffract @@ion
sapling	sap @@ling
cougar	cougar
bleacher	bleach @@er
plurality	plural @@ity
legislator	legislate @@or
desensitize	de @@sensitize
whereon	whereon
ranks	ranks
conservationist	conservation @@ist
dumbness	dumb @@ness
salmon	salmon
inventiveness	inventive @@ness
perennially	perennial @@ly
beginner	begin @@er
incomparably	incomparable @@ly
collaborate	col @@labour @@ate
hosteller	hostel @@er
jingoist	jingoist
precipitously	precipitous @@ly
formless	form @@less
companionable	companion @@able
licentiousness	licentious @@ness
smelly	smell @@y
misbehave	mis @@behave
unease	un @@ease
regression	regress @@ion
fleshings	flesh @@ing @@s
vent	vent
nationalist	nationalist
reverberation	reverberate @@ion
teak	teak
cataclysmic	cataclysm @@ic
pompous	pomp @@ous
underclothes	under @@clothes
thankfulness	thankful @@ness
sponsor	sponsor
today	today
dresser	dress @@er
forelock	fore @@lock
fluster	fluster
faulty	fault @@y
tubful	tub @@ful
morn	morn
innately	innate @@ly
dewy	dew @@y
gabble	gabble
psychically	psychical @@ly
documentary	document @@ary
unperson	un @@person
outboard	out @@board
insincerity	insincere @@ity
reborn	re @@born
powerfully	powerful @@ly
pruriently	prurient @@ly
paranoid	paranoid
silkiness	silky @@ness
canvass	canvass
organism	organ @@ism
fighter	fight @@er
signatory	signature @@ory
whereabouts	where @@about @@s
relative	relative
pecker	peck @@er
inconstant	in @@constant
proclamation	proclaim @@ation
tigerish	tiger @@ish
karate	karate
twentieth	twentieth
pennon	pennon
wench	wench
crimp	crimp
tire	tire
brutishly	brutish @@ly
foible	foible
sinner	sin @@er
circularize	circular @@ize
staunchness	staunch @@ness
primal	prime @@al
nutcracker	nut @@crack @@er
gangrene	gangrene
conjunctive	conjunction @@ive
overarm	overarm
dishy	dish @@y
calcine	calcium @@ine
determined	determined
briskly	brisk @@ly
cheerless	cheer @@less
denominate	de @@nominate
modernize	modern @@ize
skirmisher	skirmish @@er
smith	smith
measure	measure
lengthy	length @@y
heraldry	herald @@ry
misguide	mis @@guide
sealer	seal @@er
accidentally	accidental @@ly
bopper	bop @@er
uninformed	un @@informed
totter	totter
clang	clang
ethnologically	ethnological @@ly
tucker	tuck @@er
loan	loan
conditioned	conditioned
overhear	over @@hear
whites	white @@s
daydreamer	daydream @@er
evangelism	evangel @@ism
visitant	visit @@ant
appointee	appoint @@ee
mothproof	mothproof
thunderous	thunder @@ous
curtness	curt @@ness
bun	bun
creed	creed
mortgagee	mortgage @@ee
sabotage	sabotage
sixteenth	sixteen @@th
appearances	appearances
scatterbrained	scatter @@brain @@ed
pureblooded	pure @@blood @@ed
crocodile	crocodile
yield	yield
groin	groin
badly	bad @@ly
reconstitute	re @@constitute
inessential	inessential
impregnably	impregnable @@ly
mantle	mantle
vindictively	vindictive @@ly
cuffs	handcuffs
dearness	dear @@ness
retract	retract
early	early
preventively	preventive @@ly
oligarch	oligarch
mettlesome	mettle @@some
downer	down @@er
iota	iota
meaninglessness	meaningless @@ness
brassy	brass @@y
coffers	coffers
restricted	restricted
tulip	tulip
exemption	exempt @@ion
teg	teg
musically	musical @@ly
sure	sure
curliness	curly @@ness
miserable	misery @@able
molar	molar
waver	wave @@er
charger	charge @@er
anodyne	anodyne
kapok	kapok
beautifully	beautiful @@ly
snort	snort
laughably	laughable @@ly
composed	composed
hers	her @@s
vetch	vetch
uneconomic	un @@economic
composer	compose @@er
cinema	cinema
kink	kink
hooter	hoot @@er
treason	treason
dip	dip
wherein	wherein
overall	overall
elaborate	elaborate
cautionary	caution @@ary
fevered	fever @@ed
noncommittal	non @@commit @@al
stride	stride
brake	brake
premature	pre @@mature
spunky	spunk @@y
orison	orison
acumen	acumen
aggregation	aggregate @@ion
impecuniously	impecunious @@ly
grotto	grotto
letter	letter
permissively	permissive @@ly
mimetic	mimesis @@ic
fish	fish
disinter	dis @@inter
quarters	quarters
alveolar	alveolar
inversely	inverse @@ly
inevitability	inevitable @@ity
stifle	stifle
johnny	johnny
domination	dominate @@ion
forcefully	forceful @@ly
shawl	shawl
manufacture	manufacture
thanklessly	thankless @@ly
sleeplessness	sleepless @@ness
ague	ague
vestigially	vestigial @@ly
jay	jay
novitiate	novice @@ate
twig	twig
devotions	devotions
blender	blend @@er
unlawful	un @@lawful
appealingly	appealing @@ly
delay	delay
contented	contented
harshness	harsh @@ness
blankly	blank @@ly
lucratively	lucrative @@ly
hold	hold
tipsily	tipsy @@ly
ail	ail
outright	out @@right
person	person
ichneumon	ichneumon
permissibly	permissible @@ly
aside	aside
autumnal	autumn @@al
cosmetician	cosmetic @@ian
switch	switch
intercollegiate	inter @@collegiate
eccentricity	eccentric @@ity
nonsensical	nonsense @@ical
breakable	break @@able
humorously	humorous @@ly
underwrite	under @@write
tranquilly	tranquil @@ly
resentful	resent @@ful
evocative	evocation @@ive
accretion	accrete @@ion
nearness	near @@ness
incontestable	in @@contestable
congressional	congress @@al
carbonization	carbonize @@ation
jollity	jolly @@ity
swill	swill
obese	obese
annex	annex
wealthily	wealthy @@ly
ethereally	ethereal @@ly
elementary	element @@ary
standing	standing
dinkum	dinkum
statute	statute
foetal	foetus @@al
cosy	cosy
capably	capable @@ly
jimmy	jimmy
slumberous	slumber @@ous
syllabication	syllabicate @@ion
hireling	hire @@ling
swoop	swoop
commons	common @@s
drily	dry @@ly
oat	oat
spare	spare
individual	individual
sapphire	sapphire
yeomanry	yeoman @@ry
screwball	screwball
executive	executive
bookable	book @@able
polio	polio
tangential	tangent @@ial
shaddock	shaddock
combat	combat
stubbornly	stubborn @@ly
sublimate	sublimate
foretaste	fore @@taste
adorn	adorn
fillip	fillip
identification	identify @@ation
drat	drat
crib	crib
syndication	syndicate @@ion
polypous	polyp @@ous
stanza	stanza
ultimo	ultimo
bronze	bronze
tootle	tootle
inexpensive	in @@expensive
mosque	mosque
ignominiously	ignominious @@ly
freeborn	free @@born
prep	prep
prolongation	prolong @@ation
boundlessness	boundless @@ness
decoder	decode @@er
den	den
inbred	inbred
gait	gait
unmindful	un @@mindful
summat	summat
hubby	husband @@y
saurian	Sauria @@an
place	place
inspirational	inspiration @@al
reckoning	reckoning
junketing	junketing
pumpkin	pumpkin
maidenly	maiden @@ly
chronicler	chronicle @@er
hither	hither
temperamentally	temperamental @@ly
mildly	mild @@ly
hermit	hermit
winkers	wink @@er @@s
credulity	credulous @@ity
ramification	ramify @@ation
fact	fact
inexorably	inexorable @@ly
defenceless	defence @@less
singly	single @@ly
psychokinetically	psychokinetic @@ally
scholarship	scholar @@ship
paramour	paramour
exclusive	exclusive
assuage	assuage
someplace	some @@place
outfit	outfit
train	train
visualize	visual @@ize
vat	vat
threaten	threat @@en
redness	Red @@ness
alienate	alien @@ate
chrome	chrome
variant	variant
morello	morello
villeinage	villein @@age
shimmer	shimmer
elegiacal	elegy @@al
woodcutter	woodcut @@er
venturer	venture @@er
victual	victual
dehorn	de @@horn
mechanistically	mechanistic @@ally
chump	chump
syrup	syrup
chubbiness	chubby @@ness
stealthy	stealth @@y
silence	silence
coaxingly	coax @@ing @@ly
gamely	game @@ly
flawless	flaw @@less
overhand	over @@hand
thousand	thousand
consensus	consensus
sluggishly	sluggish @@ly
bohemian	Bohemia @@an
cards	cards
adjectivally	adjectival @@ly
prospects	prospects
sacrificial	sacrifice @@ial
demarcation	demarcate @@ion
emotive	emotion @@ive
compendiously	compendious @@ly
distrust	distrust
peckish	peck @@ish
introversion	introvert @@ion
contrition	contrite @@ion
mutter	mutter
impractically	impractical @@ly
droplet	drop @@let
peace	peace
pellucidly	pellucid @@ly
hysterical	hysteria @@ical
subtenant	sub @@tenant
pointsman	point @@s @@man
drag	drag
scrofula	scrofula
slither	slither
cotton	cotton
elevenses	eleven @@s @@es
fink	fink
candidacy	candidate @@cy
sabbatical	Sabbath @@ical
tediously	tedious @@ly
crash	crash
staidness	staid @@ness
fiendishly	fiendish @@ly
reciprocity	reciprocal @@ity
increase	increase
dramatize	drama @@ize
nastily	nasty @@ly
vocalize	vocal @@ize
amorousness	amorous @@ness
uncoloured	un @@coloured
swinishly	swinish @@ly
preschool	pre @@school
entrap	en @@trap
nonviolent	non @@violent
unquestionably	unquestionable @@ly
sapper	sap @@er
dreamlessly	dreamless @@ly
penniless	penny @@less
lovely	lovely
dizzy	dizzy
genitals	genital @@s
argumentatively	argumentative @@ly
nap	nap
misspend	mis @@spend
scrambler	scramble @@er
unaffected	un @@affected
felony	felon @@y
gleefully	gleeful @@ly
sottish	sot @@ish
renowned	renown @@ed
toots	toots
sapiently	sapient @@ly
endlessly	endless @@ly
martini	martini
dictatorial	dictator @@ial
rotten	rot @@en
studiously	studious @@ly
confirmed	confirmed
bract	bract
dishonourable	dishonour @@able
aspidistra	aspidistra
prejudicial	prejudice @@ial
tenantry	tenant @@ry
kidder	kid @@er
typographically	typographical @@ly
dinar	dinar
schedule	schedule
grouse	grouse
mortality	mortal @@ity
patriarchal	patriarch @@al
kingmaker	king @@make @@er
bask	bask
inflated	inflated
overcrop	over @@crop
nautically	nautical @@ly
oratorically	oratorical @@ly
reactively	reactive @@ly
approbation	approbate @@ion
squeaky	squeak @@y
manageable	manage @@able
tintinnabulation	tintinnabulum @@ation
ditto	ditto
renegade	renegade
amply	ample @@ly
wright	wright
booking	booking
mortification	mortify @@ation
jubilant	jubilate @@ant
trombonist	trombone @@ist
abrasively	abrasive @@ly
stalk	stalk
productiveness	productive @@ness
oxygenize	oxygen @@ize
prosperous	prosper @@ous
drear	drear
ballad	ballad
elfish	elf @@ish
choppiness	choppy @@ness
longwindedly	longwinded @@ly
bobbin	bobbin
darky	dark @@y
stratify	stratum @@ify
carpet	carpet
praise	praise
wallaby	wallaby
capitalize	capital @@ize
showily	showy @@ly
lummox	lummox
anklet	ankle @@let
garrulity	garrulous @@ity
marginal	margin @@al
priggishly	priggish @@ly
plantain	plantain
flirtatious	flirtation @@ous
menstruation	menstruate @@ion
lordly	lord @@ly
gratis	gratis
darning	darning
coppery	copper @@y
botanize	botany @@ize
wearisome	weary @@some
blockade	blockade
holland	holland
stoup	stoup
telegraphically	telegraphic @@ally
exaggerated	exaggerated
tragedian	tragedy @@an
spatial	space @@ial
spurn	spurn
ungenerous	un @@generous
subtlety	subtle @@ty
rehouse	re @@house
buckle	buckle
disastrously	disastrous @@ly
harelipped	hare @@lip @@ed
ale	ale
predetermination	predetermine @@ation
mistaken	mistaken
eventuality	eventual @@ity
beetling	beetling
hospitably	hospitable @@ly
touching	touching
pilferer	pilfer @@er
goal	goal
testily	testy @@ly
enthralled	enthralled
disjointedness	disjointed @@ness
dashing	dashing
forwardness	forward @@ness
ting	ting
eldest	eldest
thin	thin
sextuplet	sextuplet
recitative	recitation @@ive
jeweller	jewel @@er
country	country
cheapen	cheap @@en
misbegotten	mis @@begotten
science	science
sophisticated	sophisticated
whorled	whorl @@ed
astir	astir
rhododendron	rhododendron
unschooled	un @@schooled
doggone	doggone
groceries	groceries
molecule	molecule
singularly	singular @@ly
yahoo	yahoo
melee	melee
bewitching	bewitching
enormously	enormous @@ly
blessing	blessing
circuit	circuit
offhandedness	offhanded @@ness
rapturously	rapturous @@ly
ownerless	owner @@less
stud	stud
perfectibility	perfectible @@ity
incline	incline
evaluate	e @@value @@ate
belted	belted
ironically	ironic @@ally
oiler	oil @@er
upholstery	upholster @@ery
rankness	rank @@ness
indefiniteness	indefinite @@ness
retool	re @@tool
war	war
disgruntled	disgruntled
soporifically	soporific @@ally
textile	textile
chi	chi
wariness	wary @@ness
missing	missing
gingko	gingko
governmental	government @@al
inflame	in @@flame
groat	groat
regroup	re @@group
dissociation	dissociate @@ion
priggish	prig @@ish
steady	steady
insult	insult
phonetics	phonetic @@s
fixate	fix @@ate
alliteratively	alliterative @@ly
tannery	tan @@ery
straiten	strait @@en
eighty	eighty
quadrilateral	quadrilateral
draughty	draught @@y
misfit	mis @@fit
infinitesimal	infinite @@al
servo	servo
dissembler	dissemble @@er
tumult	tumult
valueless	value @@less
sadist	sadism @@ist
perceptively	perceptive @@ly
scope	scope
attractiveness	attractive @@ness
brush	brush
trapper	trap @@er
medico	medico
lack	lack
disorganize	dis @@organize
debt	debt
umbrella	umbrella
antiseptic	antiseptic
unadvisedly	unadvised @@ly
camphor	camphor
tyrannous	tyrant @@ous
generalize	general @@ize
elasticity	elastic @@ity
quibble	quibble
reminiscence	reminiscent @@ence
luckiness	lucky @@ness
cutlass	cutlass
pale	pale
extempore	extempore
frivolously	frivolous @@ly
disorderly	disorder @@ly
politicization	politicize @@ation
accost	accost
sewing	sewing
reflexes	reflexes
intermingle	inter @@mingle
mocking	mocking
gallantry	gallant @@ry
success	success
disproportion	dis @@proportion
godlessness	godless @@ness
scald	scald
sassafras	sassafras
heckler	heckle @@er
occidental	Occident @@al
carious	caries @@ous
centaur	centaur
quarantine	quarantine
rehash	rehash
cower	cower
militaristic	militarist @@ic
adeptly	adept @@ly
consonant	consonant
creation	create @@ion
pilfer	pilfer
sightliness	sightly @@ness
zoning	zoning
unfaithfully	unfaithful @@ly
prepossess	pre @@possess
officiate	office @@ate
soulless	soul @@less
suggestion	suggest @@ion
currishly	currish @@ly
anteater	ant @@eater
bathos	bathos
vaunter	vaunt @@er
unlike	un @@like
superfine	super @@fine
grudge	grudge
rectifier	rectify @@er
quean	quean
ambivalently	ambivalent @@ly
periods	periods
proprietor	propriety @@or
sublieutenant	sub @@lieutenant
replenish	re @@plenish
unconditionally	unconditional @@ly
seminar	seminar
unusually	unusual @@ly
impetuously	impetuous @@ly
gibingly	gibing @@ly
sermonize	sermon @@ize
daffodil	daffodil
senate	senate
detrain	de @@train
bread	bread
mourn	mourn
forthrightness	forthright @@ness
coincidentally	coincidental @@ly
naturalness	natural @@ness
vicissitude	vicissitude
give	give
thousandfold	thousandfold
adoration	adore @@ation
unctuously	unctuous @@ly
excessively	excessive @@ly
exactingly	exacting @@ly
bookishly	bookish @@ly
applied	applied
irrigation	irrigate @@ion
gracelessness	graceless @@ness
nog	nog
currish	cur @@ish
plunder	plunder
aspen	aspen
cretinous	cretin @@ous
watt	watt
array	array
determine	determine
discerning	discerning
ventricle	ventricle
aeronautics	aeronautic @@s
tepee	tepee
intercession	intercede @@ion
whaler	whale @@er
sexually	sexual @@ly
emphasize	emphasis @@ize
ogress	ogre @@ess
trilaterally	trilateral @@ly
despicable	despise @@able
ladylike	lady @@like
bewildering	bewildering
pedantic	pedant @@ic
concession	concede @@ion
inequity	in @@equity
introspective	introspection @@ive
crustily	crusty @@ly
galumph	galumph
bilabial	bilabial
methylate	methyl @@ate
concernedly	concerned @@ly
wrangle	wrangle
inboard	in @@board
requisite	requisite
limpidly	limpid @@ly
stash	stash
outback	outback
dory	dory
unman	un @@man
tenuously	tenuous @@ly
amputation	amputate @@ion
tenpins	tenpins
traumatic	trauma @@ic
press	press
misapprehend	mis @@apprehend
crumble	crumble
girlishness	girlish @@ness
rhizome	rhizome
turban	turban
seek	seek
turps	turps
soaker	soak @@er
ketchup	ketchup
weevil	weevil
acoustic	acoustic
donnishly	donnish @@ly
sectary	sect @@ary
shouting	shouting
guile	guile
perishingly	perishing @@ly
toilet	toilet
prudential	prudence @@ial
char	charwoman
purely	pure @@ly
uncivil	un @@civil
python	python
secularize	secular @@ize
researcher	research @@er
unmistakably	unmistakable @@ly
writing	writing
completeness	complete @@ness
pacifier	pacify @@er
neither	neither
canalize	canal @@ize
deflationary	deflation @@ary
analgesic	analgesia @@ic
mains	mains
aptness	apt @@ness
sweetness	sweet @@ness
correlative	correlation @@ive
quod	quod
ranker	rank @@er
snifter	snifter
tackle	tackle
terpsichorean	Terpsichore @@an
embattled	em @@battle @@ed
articulateness	articulate @@ness
wattle	wattle
hotelier	hotel @@ier
capriciously	capricious @@ly
justness	just @@ness
decadent	decadent
outwardly	outward @@ly
rearrange	re @@arrange
wilderness	wild @@ness
saint	saint
scrounger	scrounge @@er
clippie	clip @@ie
quadrophonic	quadrophony @@ic
proof	prove
undue	un @@due
faultless	fault @@less
seduction	seduce @@ion
clubfooted	clubfoot @@ed
knockers	knockers
fab	fab
glittering	glittering
falcon	falcon
boyhood	boy @@hood
whittler	whittle @@er
file	file
undercut	undercut
gerrymander	gerrymander
legitimatize	legitimate @@ize
butch	butch
delimit	de @@limit
forging	forging
marijuana	marijuana
nobble	nobble
sulks	sulk @@s
stomachful	stomach @@ful
solicitation	solicit @@ation
mod	mod
ornamentally	ornamental @@ly
feeble	feeble
assess	assess
trendy	trendy
cayenne	cayenne
phalarope	phalarope
deterministic	determinism @@ic
childishly	childish @@ly
abominably	abominable @@ly
deceptive	deception @@ive
tuneful	tune @@ful
bad	bad
unbind	un @@bind
supplementary	supplement @@ary
rejoinder	rejoin @@er
prepay	pre @@pay
ostrich	ostrich
defrayal	defray @@al
idleness	idle @@ness
incumbent	incumbent
finable	fine @@able
astrological	astrology @@ical
staunch	staunch
osculation	osculate @@ion
stoppage	stop @@age
eccentric	eccentric
facing	facing
cohesive	cohesion @@ive
intrusive	intrusion @@ive
knee	knee
olive	olive
tasselled	tassel @@ed
uncouple	un @@couple
conservatively	conservative @@ly
hammock	hammock
polemically	polemical @@ly
toxicologist	toxicology @@ist
pronounceable	pronounce @@able
wanker	wank @@er
superintend	super @@intend
separatist	separate @@ist
egg	egg
burthen	burthen
unleash	un @@leash
veranda	veranda
euphonious	euphony @@ous
cancerously	cancerous @@ly
piddling	piddling
doubly	double @@ly
sigh	sigh
catchy	catch @@y
frills	frills
catarrh	catarrh
bargee	barge @@ee
sparrow	sparrow
republican	republic @@an
dissimulate	dis @@simulate
legalism	legal @@ism
wetness	wet @@ness
dedication	dedicate @@ion
musician	music @@ian
contrapuntally	contrapuntal @@ly
amphibious	amphibian @@ous
primordially	primordial @@ly
piper	pipe @@er
trackless	track @@less
integrally	integral @@ly
tutu	tutu
demographer	demography @@er
prosper	prosper
solidus	solidus
alternative	alternative
deodorize	de @@odour @@ize
calendar	calendar
indoor	in @@door
pomposity	pompous @@ity
blimp	blimp
dyne	dyne
certainly	certain @@ly
picnicker	picnic @@er
influx	in @@flux
enslave	en @@slave
lagging	lagging
exception	except @@ion
strong	strong
unfortunate	un @@fortunate
atrophy	atrophy
spiral	spiral
effervescence	effervescent @@ence
prohibitive	prohibition @@ive
stuffily	stuffy @@ly
balaclava	balaclava
pooch	pooch
myth	myth
lie	lie
swingeing	swingeing
shortsightedness	shortsighted @@ness
nainsook	nainsook
mirth	mirth
protect	protect
articulately	articulate @@ly
embolden	em @@bold @@en
pushing	pushing
xenophobic	xenophobia @@ic
elaborateness	elaborate @@ness
bestride	be @@stride
goliath	Goliath
barbel	barbel
crushing	crushing
finickity	finicky @@ity
motorist	motor @@ist
bombastic	bombast @@ic
industriously	industrious @@ly
disallow	dis @@allow
free	free
insipidity	insipid @@ity
downhearted	down @@heart @@ed
sulphuric	sulphur @@ic
nosedive	nosedive
diner	dine @@er
jail	jail
reification	reify @@ation
boned	boned
flavouring	flavouring
tension	tense @@ion
salvation	salvage @@ation
greasily	greasy @@ly
deeply	deep @@ly
round	round
witching	witch @@ing
lacrosse	lacrosse
citrus	citrus
relativistic	relativity @@ic
ancestress	ancestor @@ess
remount	remount
alumna	alumna
skylark	skylark
stratagem	stratagem
cachet	cachet
experimental	experiment @@al
osteopathy	osteopath @@y
peasant	peasant
feat	feat
research	research
interphone	inter @@phone
clerically	clerical @@ly
grammar	grammar
optative	optative
monarchist	monarchist
flashy	flash @@y
dubbing	dubbing
rust	rust
fresh	fresh
hijacker	hijack @@er
elaborately	elaborate @@ly
tickler	tickle @@er
fanfare	fanfare
scrap	scrap
fumigate	fume @@ate
probingly	probing @@ly
toucher	touch @@er
distressing	distressing
soldierlike	soldier @@like
activation	activate @@ion
pare	pare
cowling	cowling
haul	haul
beatification	beatify @@ation
duster	dust @@er
formative	formation @@ive
caper	caper
canter	canter
mastermind	mastermind
hark	hark
clockwise	clock @@wise
bullshit	bullshit
recorder	record @@er
grovel	grovel
grotesqueness	grotesque @@ness
mane	mane
bunk	bunk
strait	strait
reed	reed
grass	grass
yen	yen
distemper	dis @@temper
transmutable	transmute @@able
toxic	toxin @@ic
wager	wage @@er
wrestler	wrestle @@er
aspiration	aspire @@ation
embosomed	em @@bosom @@ed
mummer	mum @@er
thence	thence
competitor	compete @@or
adieu	adieu
rhythmical	rhythm @@ical
torridity	torrid @@ity
rouse	rouse
sphere	sphere
riskiness	risky @@ness
loudspeaker	loud @@speak @@er
hormone	hormone
recording	recording
salvage	salvage
nag	nag
snare	snare
wrongfully	wrongful @@ly
babyish	baby @@ish
deplorable	deplore @@able
pusillanimously	pusillanimous @@ly
review	re @@view
fighting	fighting
disputation	dispute @@ation
secrecy	secret @@cy
snooze	snooze
rerun	re @@run
sphincter	sphincter
macadam	macadam
offensively	offensive @@ly
calibration	calibrate @@ion
fissionable	fission @@able
troublemaker	trouble @@make @@er
overtake	over @@take
squiggly	squiggle @@y
scrimp	scrimp
valuer	value @@er
incommensurate	in @@commensurate
fetid	fetid
showy	show @@y
splashy	splash @@y
uterine	uterus @@ine
underweight	under @@weight
swat	swat
lethargically	lethargic @@ally
confederate	confederate
usurpation	usurp @@ation
solvent	solvent
driving	driving
inappropriate	in @@appropriate
mysterious	mystery @@ous
walking	walking
sprint	sprint
tracer	trace @@er
pluck	pluck
sanctimoniously	sanctimonious @@ly
knightly	knight @@ly
return	return
depravity	deprave @@ity
amazing	amazing
morally	moral @@ly
squeezer	squeeze @@er
rival	rival
fleetly	fleet @@ly
palatially	palatial @@ly
capitalist	capitalist
resonator	resonate @@or
disembowel	dis @@em @@bowel
tat	tat
personalities	personalities
cognoscenti	cognoscenti
marshy	marsh @@y
masquerade	masquerade
invasion	invade @@ion
helpfulness	helpful @@ness
coercion	coerce @@ion
solicitousness	solicitous @@ness
maudlin	maudlin
futurism	future @@ism
rains	rains
expressionless	expression @@less
upholder	uphold @@er
swain	swain
realness	real @@ness
corvee	corvee
councillor	council @@or
unseasoned	un @@seasoned
turbulently	turbulent @@ly
darling	darling
sunken	sunken
singer	sing @@er
mispronounce	mis @@pronounce
codswallop	codswallop
frequent	frequent
younger	younger
flail	flail
laity	lay @@ity
abuse	abuse
deification	deify @@ation
checkers	checkers
irrecoverably	irrecoverable @@ly
hieroglyphic	hieroglyph @@ic
effective	effect @@ive
incoherence	incoherent @@ence
humanist	humanist
nomination	nominate @@ion
pagan	pagan
sub	sub
aubergine	aubergine
spoon	spoon
decolonize	de @@colonize
memorialize	memorial @@ize
revengeful	revenge @@ful
thermionics	thermionic @@s
demented	demented
repellent	repellent
frighteningly	frightening @@ly
frumpish	frump @@ish
chiffonier	chiffon @@ier
orgasm	orgasm
objector	object @@or
bump	bump
faeces	faeces
proven	proven
barrelled	barrelled
shipping	shipping
strangeness	strange @@ness
levodopa	levodopa
ineffability	ineffable @@ity
forewarn	fore @@warn
openness	open @@ness
harbour	harbour
tormentor	torment @@or
puree	puree
purge	purge
lounge	lounge
cupola	cupola
yob	yob
bittiness	bitty @@ness
tillage	till @@age
false	false
evanescence	evanescent @@ence
adroitness	adroit @@ness
excusably	excusable @@ly
baby	baby
vague	vague
illiteracy	illiterate @@cy
typify	type @@ify
grippingly	gripping @@ly
nonassertive	non @@assertive
inactivate	inactive @@ate
roomy	room @@y
reforest	re @@forest
revisionism	revision @@ism
offing	off @@ing
classify	class @@ify
special	special
law	law
monotonously	monotonous @@ly
rat	rat
unofficially	unofficial @@ly
piffling	piffling
sprit	sprit
bagful	bag @@ful
conversation	converse @@ation
modally	modal @@ly
kitschy	kitsch @@y
chuck	chuck
crisp	crisp
cyclostyle	cyclostyle
polemics	polemics
sybarite	Sybaris @@ite
indisposition	in @@disposition
thanklessness	thankless @@ness
vacancy	vacant @@ancy
button	button
socialize	social @@ize
scrip	scrip
leotard	leotard
pom	pom
catapult	catapult
ruination	ruin @@ation
dreaminess	dreamy @@ness
din	din
engagingly	engaging @@ly
compartmental	compartment @@al
elevated	elevated
burst	burst
insole	in @@sole
perisher	perish @@er
familial	family @@al
instructional	instruction @@al
display	display
cow	cow
misapply	mis @@apply
aurally	aural @@ly
necessitous	necessity @@ous
roneo	roneo
generosity	generous @@ity
preciousness	precious @@ness
mnemonic	mnemonic
eared	ear @@ed
crematory	cremation @@ory
track	track
fierily	fiery @@ly
pick	pick
crosscheck	crosscheck
phallic	phallus @@ic
kittenishly	kittenish @@ly
comb	comb
servilely	servile @@ly
hectare	hectare
bemuse	be @@muse
entertainingly	entertaining @@ly
skip	skip
snorty	snort @@y
hornlike	horn @@like
unfailingly	unfailing @@ly
procreation	procreate @@ion
enigmatical	enigma @@ical
solid	solid
tendril	tendril
acrobatic	acrobat @@ic
appetizingly	appetizing @@ly
screening	screening
sneerer	sneer @@er
official	office @@ial
rose	rose
invertebrate	in @@vertebrate
asexually	asexual @@ly
compile	compile
utilitarian	utilitarian
gamboge	gamboge
openheartedly	openhearted @@ly
worst	worst
nudge	nudge
unbar	un @@bar
grotesquely	grotesque @@ly
accrete	accrete
uphill	uphill
aid	aid
pencil	pencil
prompt	prompt
shooting	shooting
slatted	slat @@ed
deformation	deform @@ation
copyholder	copyhold @@er
thine	thine
puritan	puritan
catastrophic	catastrophe @@ic
barefooted	barefooted
your	your
shiny	shine @@y
rascal	rascal
secularist	secularism @@ist
meantime	meantime
tarragon	tarragon
pettishly	pettish @@ly
plankton	plankton
heavily	heavy @@ly
stocks	stocks
stammeringly	stammering @@ly
puss	puss
involuntariness	involuntary @@ness
priestlike	priest @@like
croon	croon
decompression	decompress @@ion
fragility	fragile @@ity
conceitedly	conceited @@ly
decongestant	de @@congest @@ant
lag	lag
unsparingly	unsparing @@ly
beggary	beggar @@y
subpoena	subpoena
silence	silent @@ence
gladly	glad @@ly
expectancy	expectant @@ancy
inanimate	in @@animate
socialite	social @@ite
commemoration	commemorate @@ion
welder	weld @@er
eroticism	erotic @@ism
stench	stench
uncharitable	un @@charitable
felicitous	felicity @@ous
phut	phut
clownishness	clownish @@ness
upholsterer	upholster @@er
exchangeable	exchange @@able
typewritten	typewritten
steed	steed
homeliness	homely @@ness
leafage	leaf @@age
surgically	surgical @@ly
windless	wind @@less
abnegation	abnegate @@ion
sadden	sad @@en
appointments	appointments
rationality	rational @@ity
obstinately	obstinate @@ly
philatelist	philately @@ist
reconsideration	reconsider @@ation
venomously	venomous @@ly
stylistically	stylistic @@ally
robustness	robust @@ness
latticed	lattice @@ed
abjection	abject @@ion
each	each
pogrom	pogrom
crustiness	crusty @@ness
rood	rood
freewheeling	freewheeling
chaser	chase @@er
cocoon	cocoon
neuralgic	neuralgia @@ic
moppet	moppet
spacing	spacing
cheapness	cheap @@ness
kindling	kindling
bean	bean
lordliness	lordly @@ness
bonds	bonds
placenta	placenta
ornateness	ornate @@ness
suavely	suave @@ly
wyvern	wyvern
vindictiveness	vindictive @@ness
panga	panga
vagina	vagina
prestidigitator	prestidigitation @@or
perfumier	perfume @@ier
buster	bust @@er
beneficence	beneficent @@ence
overcast	over @@cast
rosin	rosin
racy	race @@y
sinless	sin @@less
unlock	un @@lock
challenge	challenge
lira	lira
soviet	soviet
capacity	capacious @@ity
pardon	pardon
inn	inn
lee	lee
electricly	electric @@ly
reformative	reformation @@ive
alluring	alluring
petrifaction	petrify @@ion
mislay	mis @@lay
pierce	pierce
bode	bode
unpretentiously	unpretentious @@ly
inestimably	inestimable @@ly
greenishness	greenish @@ness
textured	texture @@ed
flasher	flash @@er
latitudinal	latitude @@al
demagogic	demagogy @@ic
indignity	in @@dignity
fore	fore
festivity	festive @@ity
causality	causal @@ity
poky	poke @@y
unsaid	un @@said
whey	whey
reposeful	repose @@ful
vesicle	vesicle
stentorian	Stentor @@ian
weakly	weak @@ly
classy	class @@y
frilly	frill @@y
sheepishness	sheepish @@ness
somehow	some @@how
chief	chief
beige	beige
relative	relation @@ive
lexically	lexical @@ly
numerate	number @@ate
fecundity	fecund @@ity
feudatory	feudal @@ory
chunk	chunk
reprehensibly	reprehensible @@ly
convert	convert
alexic	alexia @@ic
airily	airy @@ly
neglectfulness	neglectful @@ness
mannered	manner @@ed
fewness	few @@ness
arrester	arrest @@er
glutinous	gluten @@ous
fourth	fourth
oust	oust
joinery	join @@ery
cleanse	cleanse
oceanic	ocean @@ic
lamentable	lament @@able
hum	hum
metro	Metro
deterrent	deterrent
misunderstanding	misunderstanding
white	white
cryptographic	cryptography @@ic
sturgeon	sturgeon
persecutor	persecute @@or
settee	settee
superannuation	superannuate @@ion
gutsy	guts @@y
impeller	impel @@er
astute	astute
bring	bring
blearily	bleary @@ly
observable	observe @@able
wintry	winter @@y
record	record
whereby	whereby
splinter	splinter
jingoism	jingo @@ism
palatial	palace @@ial
allopathically	allopathical @@ly
release	release
shoulder	shoulder
scanty	scant @@y
jocose	jocose
challenger	challenge @@er
intransigence	intransigent @@ence
forwards	forward @@s
mayoralty	mayoral @@ty
encyclical	en @@cyclical
assessor	assess @@or
torpidity	torpid @@ity
viva	viva
tenaciously	tenacious @@ly
elision	elide @@ion
plentifully	plentiful @@ly
unholy	un @@holy
allopathic	allopathy @@ic
educationally	educational @@ly
forger	forge @@er
calumniate	calumny @@ate
teaspoonful	teaspoon @@ful
harbourer	harbour @@er
cookie	cook @@ie
rousing	rousing
casuistic	casuist @@ic
garret	garret
something	something
compensation	compensate @@ion
complaisantly	complaisant @@ly
head	head
sloppiness	sloppy @@ness
rainless	rain @@less
polyglot	polyglot
dangerous	danger @@ous
davit	davit
bascule	bascule
brinksmanship	brink @@s @@man @@ship
prestressed	pre @@stressed
dumpling	dump @@ling
chop	chop
manic	mania @@ic
kudos	kudos
hurdler	hurdle @@er
pressurization	pressurize @@ation
gorgon	gorgon
slogan	slogan
impish	imp @@ish
emeritus	emeritus
other	other
unapproachable	un @@approachable
reefer	reef @@er
tussle	tussle
encyclopedically	encyclopedic @@ally
biped	biped
timorousness	timorous @@ness
conspiratorial	conspirator @@ial
smoker	smoke @@er
chummy	chum @@y
wild	wild
magus	magus
inappropriateness	inappropriate @@ness
confidentially	confidential @@ly
preoccupy	pre @@occupy
shipment	ship @@ment
cohesiveness	cohesive @@ness
cannily	canny @@ly
freckled	freckle @@ed
complainingly	complain @@ing @@ly
immaculately	immaculate @@ly
wooded	wood @@ed
singleness	single @@ness
toughly	tough @@ly
vandalize	vandal @@ize
successive	succession @@ive
aggregate	aggregate
idealist	idealism @@ist
lather	lather
careless	care @@less
craze	craze
indigenously	indigenous @@ly
articulated	articulated
nattily	natty @@ly
dick	dick
simplification	simplify @@ation
ravenously	ravenous @@ly
unprincipled	un @@principled
deficiently	deficient @@ly
lure	lure
foreplay	fore @@play
mobile	mobile
smuggling	smuggling
profoundly	profound @@ly
misgiving	mis @@giving
remilitarize	re @@militarize
light	light
bonnet	bonnet
surrogate	surrogate
crutch	crutch
seasoning	seasoning
futuristic	futurist @@ic
harass	harass
sicken	sick @@en
buffer	buffer
continuation	continue @@ation
domed	dome @@ed
amuck	amuck
trawl	trawl
secessionist	secession @@ist
eulogistic	eulogist @@ic
gen	gen
backfire	backfire
skate	skate
tactless	tact @@less
enlightened	enlightened
bungler	bungle @@er
nonverbally	nonverbal @@ly
mute	mute
unobtrusively	unobtrusive @@ly
pricily	pricey @@ly
whirr	whirr
rare	rare
betrothed	betrothed
vassal	vassal
designedly	design @@ed @@ly
centrist	centrist
tomb	tomb
inpouring	inpouring
luminously	luminous @@ly
laxative	laxation @@ive
veining	vein @@ing
three	three
unceremonious	un @@ceremonious
hustle	hustle
overstrung	over @@strung
interpellation	interpellate @@ion
raftsman	raft @@s @@man
complainant	complain @@ant
oversubscribed	over @@subscribed
nadir	nadir
demolition	demolish @@ion
shark	shark
impersonator	impersonate @@or
palpation	palpate @@ion
taxidermist	taxidermy @@ist
irrepressibly	irrepressible @@ly
deductive	deduction @@ive
pricey	price @@y
precise	precise
venerable	venerate @@able
prioress	prior @@ess
corporal	corporal
fleck	fleck
vengefully	vengeful @@ly
scandalize	scandal @@ize
realm	realm
softness	soft @@ness
bird	bird
purl	purl
manoeuvrer	manoeuvre @@er
trepan	trepan
beginning	beginning
observingly	observing @@ly
mature	mature
suede	suede
lyrics	lyrics
rickets	rickets
squareness	square @@ness
expensive	expense @@ive
credulousness	credulous @@ness
thermion	thermo @@ion
demagoguery	demagogue @@ery
extenuation	extenuate @@ion
thorny	thorn @@y
whole	whole
freighter	freight @@er
obstructive	obstruction @@ive
fourteenth	fourteenth
supernumerary	super @@numerary
ephemerally	ephemeral @@ly
palmy	palm @@y
saltiness	salty @@ness
toiler	toil @@er
improbably	improbable @@ly
roll	roll
corrupt	corrupt
vermifuge	vermifuge
torrential	torrent @@ial
fascinatingly	fascinating @@ly
bard	bard
unarmed	un @@armed
gnu	gnu
inbound	in @@bound
golf	golf
spectacled	spectacle @@ed
changelessly	changeless @@ly
teeter	teeter
discus	discus
disqualification	disqualify @@ation
corrosion	corrode @@ion
openheartedness	openhearted @@ness
telephone	telephone
church	church
jobbery	job @@ery
sweater	sweat @@er
transfusion	transfuse @@ion
choreographer	choreography @@er
undischarged	un @@discharged
lipid	lipid
scrounge	scrounge
writings	writings
mesa	mesa
sonority	sonorous @@ity
disgust	disgust
hymnal	hymn @@al
unfailing	un @@failing
vest	vest
fogginess	foggy @@ness
coley	coley
verdict	verdict
flush	flush
harmattan	harmattan
stripe	stripe
anonymity	anonymous @@ity
internee	intern @@ee
forenoon	fore @@noon
pentagonal	pentagon @@al
powerful	power @@ful
conditional	condition @@al
unlike	unlike
underworld	under @@world
paladin	paladin
recoverable	recover @@able
transistorize	transistor @@ize
mizzle	mizzle
crumple	crumple
imposingly	imposing @@ly
dabs	dab @@s
chemical	chemical
irritation	irritate @@ion
prophesy	prophesy
decently	decent @@ly
bunkered	bunker @@ed
largeish	large @@ish
friskiness	frisky @@ness
adulterate	adultery @@ate
octavo	octavo
affront	affront
enchantingly	enchanting @@ly
evacuation	evacuate @@ion
harrow	harrow
nurse	nurse
cautiousness	cautious @@ness
lectern	lectern
smugly	smug @@ly
yoke	yoke
restively	restive @@ly
breech	breech
plastered	plastered
jazzily	jazzy @@ly
dress	dress
zany	zany
languorous	languor @@ous
sunny	sun @@y
kernel	kernel
tort	tort
complexity	complex @@ity
license	license
physiologist	physiology @@ist
protestingly	protesting @@ly
cogitation	cogitate @@ion
corrosively	corrosive @@ly
curacoa	curacoa
loquaciousness	loquacious @@ness
foreleg	fore @@leg
figuratively	figurative @@ly
amicably	amicable @@ly
catatonic	catatonia @@ic
colonist	colony @@ist
neutralizer	neutralize @@er
eaves	eaves
blockage	block @@age
angst	angst
availability	available @@ity
savoy	savoy
obligatory	obligation @@ory
cragged	crag @@ed
contrarily	contrary @@ly
commodore	commodore
drab	drab
disquiet	disquiet
leaf	leaf
subway	sub @@way
safeguard	safeguard
ablutions	ablutions
perfidiousness	perfidious @@ness
connotative	connotation @@ive
razzle	razzle
resplendence	resplendent @@ence
snappish	snap @@ish
ruminatively	ruminative @@ly
duly	due @@ly
separation	separate @@ion
aspirin	aspirin
knead	knead
befog	be @@fog
inferior	inferior
fornication	fornicate @@ion
disable	dis @@able
balm	balm
bestiality	bestial @@ity
inconsistent	in @@consistent
impressionist	impressionist
strop	strop
docility	docile @@ity
thinking	thinking
riverside	riverside
golden	gold @@en
steadily	steady @@ly
caboose	caboose
quoit	quoit
ashes	ashes
foundress	founder @@ess
ebb	ebb
stuffing	stuffing
tab	tab
lychee	lychee
joke	joke
venomous	venom @@ous
greaser	grease @@er
partnership	partner @@ship
rewrite	re @@write
industrialist	industrialism @@ist
pallet	pallet
sedate	sedate
successively	successive @@ly
cunt	cunt
she	she
bootless	boot @@less
baptismal	baptism @@al
distinctiveness	distinctive @@ness
conch	conch
tittle	tittle
fluky	fluke @@y
variegation	variegate @@ion
cosmetic	cosmetic
seniority	senior @@ity
booby	boob @@y
notability	notable @@ity
carver	carve @@er
cosignatory	cosignatory
kaolin	kaolin
morbidity	morbid @@ity
secretarial	secretary @@al
duckling	duck @@ling
cumin	cumin
lagoon	lagoon
protein	protein
exhibit	exhibit
supertax	super @@tax
rudeness	rude @@ness
fixed	fixed
concomitantly	concomitant @@ly
iniquitous	iniquity @@ous
thwack	thwack
noticeable	notice @@able
mall	mall
form	form
conductress	conductor @@ess
dynamic	dynamic
unconsidered	un @@considered
palais	palais
ungratefully	ungrateful @@ly
willow	willow
teleologist	teleology @@ist
hoaxer	hoax @@er
endless	end @@less
manatee	manatee
spin	spin
growlingly	growling @@ly
rustproof	rustproof
unbearably	unbearable @@ly
add	add
impresario	impresario
blissfulness	blissful @@ness
equestrian	equestrian
bleachers	bleachers
instrumentation	instrument @@ation
tusk	tusk
draggled	draggled
blindly	blind @@ly
seamy	seam @@y
ethics	ethics
vermilion	vermilion
prepack	pre @@pack
incomparability	incomparable @@ity
staccato	staccato
latex	latex
hornless	horn @@less
neighbourliness	neighbourly @@ness
revolutionize	revolution @@ize
sulphonamide	sulphonamide
meditatively	meditative @@ly
casque	casque
machinery	machine @@ery
filminess	filmy @@ness
facileness	facile @@ness
roominess	roomy @@ness
sequin	sequin
believer	believe @@er
disengaged	dis @@engaged
oceanographer	oceanography @@er
understudy	under @@study
gluttonous	glutton @@ous
overtures	overtures
design	design
authenticate	authentic @@ate
fluoridization	fluoridize @@ation
saddler	saddle @@er
uncharitably	uncharitable @@ly
epaulet	epaulet
hookah	hookah
deadly	deadly
delineation	delineate @@ion
desirous	desire @@ous
greyish	grey @@ish
cravenly	craven @@ly
leastwise	least @@wise
clannishness	clannish @@ness
grief	grieve
dexterously	dexterous @@ly
pidgin	pidgin
tyrannically	tyrannical @@ly
uncertain	un @@certain
emotionally	emotional @@ly
associate	associate
motions	motions
discovery	discover @@ery
vivacity	vivacious @@ity
flinty	flint @@y
pawpaw	pawpaw
leech	leech
tress	tress
mousse	mousse
acceptably	acceptable @@ly
incredulous	in @@credulous
punily	puny @@ly
stinking	stinking
terrifically	terrific @@ally
taunting	taunting
trivially	trivial @@ly
bucolically	bucolic @@ally
fiddle	fiddle
kimono	kimono
unassumingly	unassuming @@ly
voyage	voyage
porridge	porridge
commodiously	commodious @@ly
secretly	secret @@ly
intellect	intellect
bridle	bridle
probe	probe
cyst	cyst
gambler	gamble @@er
variably	variable @@ly
undertaker	undertake @@er
criminologist	criminology @@ist
sundries	sundry @@s
shoplifting	shoplifting
bleat	bleat
cense	incense
ben	ben
submersion	submerse @@ion
renascent	re @@nascent
devilish	devilish
omission	omit @@ion
guileful	guile @@ful
fife	fife
demonic	demon @@ic
say	say
lid	lid
conviction	convict @@ion
advert	advertisement
bestial	beast @@ial
crossbreed	crossbreed
unhappily	unhappy @@ly
meeting	meeting
piquancy	piquant @@ancy
lynch	lynch
infra	infra
gelding	gelding
coating	coating
demagnetize	de @@magnet @@ize
shack	shack
petitioner	petition @@er
squab	squab
recce	recce
loo	loo
pump	pump
tec	detective
onshore	onshore
epoch	epoch
supple	supple
quern	quern
gage	gage
crusader	crusade @@er
advantageously	advantageous @@ly
pitiable	pity @@able
objective	objective
nightmarish	nightmare @@ish
loom	loom
consolidate	con @@solid @@ate
technicality	technical @@ity
drunk	drunk
versify	verse @@ify
progress	progress
vividly	vivid @@ly
leprechaun	leprechaun
interdenominational	inter @@denominational
marvellous	marvel @@ous
prefigure	pre @@figure
cumbrous	cumber @@ous
disinfection	disinfect @@ion
facility	facile @@ity
flask	flask
incorrigibility	incorrigible @@ity
subatomic	sub @@atomic
skein	skein
shall	shall
warmness	warm @@ness
monogamously	monogamous @@ly
blooming	bloom @@ing
slouchingly	slouching @@ly
wrathfully	wrathful @@ly
window	window
offhand	offhand
greyness	grey @@ness
portals	portals
lukewarmness	lukewarm @@ness
tributary	tribute @@ary
cash	cash
upper	upper
squeamishness	squeamish @@ness
shadowboxing	shadowboxing
photography	photograph @@y
demagogy	demagogue @@y
piss	piss
understate	under @@state
marram	marram
smitten	smitten
befitting	befitting
tinker	tinker
seamless	seam @@less
utopian	utopia @@an
delightful	delight @@ful
equatorial	equator @@ial
farsighted	far @@sight @@ed
anachronistically	anachronistic @@ally
smut	smut
aromatic	aroma @@ic
refine	re @@fine
cruelly	cruel @@ly
psychedelic	psychedelic
dynastic	dynasty @@ic
drizzly	drizzle @@y
boo	boo
mundanely	mundane @@ly
nearsighted	near @@sight @@ed
loudly	loud @@ly
offset	offset
racketeering	racketeering
slumbrous	slumber @@ous
horizontally	horizontal @@ly
veraciously	veracious @@ly
ormolu	ormolu
tariff	tariff
ninth	ninth
providing	providing
predestine	pre @@destine
inaudible	in @@audible
listless	list @@less
remission	remit @@ion
outhouse	out @@house
parole	parole
little	little
wrongly	wrong @@ly
gala	gala
whys	why @@s
principally	principal @@ly
fleet	fleet
childbearing	childbearing
weed	weed
stead	stead
phone	phone
dispirit	dis @@spirit
styrene	styrene
overtones	overtones
disparagingly	disparaging @@ly
moony	moon @@y
refloat	re @@float
scenery	scene @@ery
hassle	hassle
cynicism	cynic @@ism
damages	damages
assassinate	assassin @@ate
prohibitionist	prohibition @@ist
definitely	definite @@ly
contender	contend @@er
presto	presto
retread	re @@tread
footage	foot @@age
marguerite	marguerite
algebra	algebra
ringlet	ring @@let
prevarication	prevaricate @@ion
conservatory	conservation @@ory
ordinance	ordinance
concurrently	concurrent @@ly
protector	protect @@or
spiritualization	spiritualize @@ation
accessory	access @@ory
vulgarization	vulgarize @@ation
languid	languid
preparedness	prepared @@ness
graphically	graphic @@ally
debark	de @@bark
drip	drip
tactically	tactical @@ly
bawdily	bawdy @@ly
bowler	bowl @@er
abaft	abaft
falls	falls
utensil	utensil
acidulated	acidulated
sleepwalker	sleepwalk @@er
least	least
repairer	repair @@er
reputedly	reputed @@ly
buffet	buffet
declaratory	declaration @@ory
staggeringly	staggering @@ly
adjectival	adjective @@al
heuristically	heuristic @@ally
discharge	discharge
mew	mew
psalmody	psalm @@y
strive	strive
tuck	tuck
coloured	colour @@ed
dint	dint
wig	wig
incandescence	incandescent @@ence
rest	rest
outbalance	out @@balance
affray	affray
cretonne	cretonne
disappointedly	disappointed @@ly
harmoniousness	harmonious @@ness
neat	neat
suddenness	sudden @@ness
vigorous	vigour @@ous
folklorist	folklore @@ist
drunkenness	drunken @@ness
unflappable	un @@flap @@able
drudgery	drudge @@ery
synthetically	synthetic @@ally
penurious	penury @@ous
cumbersome	cumber @@some
skinny	skin @@y
gloom	gloom
falsify	false @@ify
benightedly	benighted @@ly
leaderless	leader @@less
deaden	dead @@en
moderations	moderation @@s
snidely	snide @@ly
bloodthirstiness	bloodthirsty @@ness
study	study
ask	ask
parsimonious	parsimony @@ous
emphatically	emphatic @@ally
breathlessness	breathless @@ness
gravel	gravel
duel	duel
upheaval	up @@heave @@al
colonization	colonize @@ation
hairiness	hairy @@ness
dictate	dictate
magnet	magnet
indolently	indolent @@ly
incurability	incurable @@ity
phosphoric	phosphorus @@ic
alarm	alarm
musical	music @@al
sentimentalism	sentimental @@ism
hulk	hulk
contusion	contuse @@ion
regulo	Regulo
proportions	proportions
stodgy	stodge @@y
skiver	skive @@er
dibber	dib @@er
napkin	napkin
transcendentalist	transcendentalism @@ist
shrive	shrive
onwards	onward @@s
coy	coy
strength	strong @@th
daemonic	daemon @@ic
cyclist	cycle @@ist
cheap	cheap
wrapping	wrapping
motto	motto
tribune	tribune
woodenly	wooden @@ly
anthropomorphic	anthropomorphism @@ic
algorithm	algorithm
trumpeter	trumpet @@er
pod	pod
armed	armed
contingently	contingent @@ly
gemmed	gem @@ed
sung	sung
learner	learn @@er
admirable	admire @@able
prospect	prospect
meld	meld
theatrical	theatre @@ical
sty	sty
beardless	beard @@less
rover	rove @@er
tamable	tame @@able
frighten	fright @@en
admiration	admire @@ation
shipbuilding	ship @@building
canna	canna
consolable	console @@able
restiveness	restive @@ness
militarist	militarism @@ist
broadmindedly	broadminded @@ly
sow	sow
profanation	profane @@ation
bitchy	bitch @@y
yak	yak
cryptographically	cryptographic @@ally
mum	mum
appreciative	appreciation @@ive
pally	pall @@y
toby	toby
forte	forte
derby	derby
impracticality	impractical @@ity
calibrate	calibre @@ate
rightful	right @@ful
swallowtailed	swallow @@tail @@ed
inward	inward
moulder	mould @@er
acting	acting
delusion	delude @@ion
recalcitrancy	recalcitrant @@ancy
seminarist	seminary @@ist
forsaken	forsaken
sting	sting
imminence	imminent @@ence
jesuitical	Jesuit @@ical
appropriateness	appropriate @@ness
degeneration	degenerate @@ion
zebra	zebra
pulverization	pulverize @@ation
scarcity	scarce @@ity
canteen	canteen
letters	letters
presentably	presentable @@ly
malcontented	malcontent @@ed
loco	loco
ascendancy	ascendant @@ancy
inexpiably	inexpiable @@ly
softener	soften @@er
opera	opera
hank	hank
grimace	grimace
privet	privet
commissioner	commission @@er
sumac	sumac
dissent	dissent
saw	saw
shore	shore
philologically	philological @@ly
squashiness	squashy @@ness
charged	charged
indispensably	indispensable @@ly
tempo	tempo
blissful	bliss @@ful
pushy	push @@y
thoughtfulness	thoughtful @@ness
frog	frog
behead	be @@head
diametrical	diameter @@ical
frothy	froth @@y
capitalism	capital @@ism
loftily	lofty @@ly
milch	milch
hasp	hasp
ice	ice
percussive	percussion @@ive
guarantee	guarantee
constant	constant
unspeakably	unspeakable @@ly
circular	circular
briskness	brisk @@ness
vole	vole
irretrievably	irretrievable @@ly
moulding	moulding
cadaverous	cadaver @@ous
underplay	under @@play
inexplicably	inexplicable @@ly
whale	whale
mahatma	mahatma
chivalrously	chivalrous @@ly
pugilistic	pugilist @@ic
bigamist	bigamy @@ist
tunneller	tunnel @@er
gripping	gripping
dowel	dowel
chlorination	chlorinate @@ion
mockery	mock @@ery
above	above
counterplot	counterplot
filtrate	filter @@ate
yucca	yucca
saurian	saurian
charmer	charm @@er
evaluation	evaluate @@ion
objectivity	objective @@ity
shrapnel	shrapnel
cracker	crack @@er
sheila	sheila
lenience	lenient @@ence
greens	greens
exportable	export @@able
surveying	surveying
maraud	maraud
gesticulation	gesticulate @@ion
ruggedly	rugged @@ly
illiterately	illiterate @@ly
petrologist	petrology @@ist
equivalence	equivalent @@ence
coquettishly	coquettish @@ly
none	none
homicidal	homicide @@al
numismatist	numismatic @@ist
ninetieth	ninety @@th
infinitely	infinite @@ly
priory	prior @@ory
entresol	entresol
unfounded	un @@founded
spell	spell
excuse	excuse
overpay	over @@pay
guard	guard
mulch	mulch
hoist	hoist
carapace	carapace
salesman	sale @@s @@man
mousy	mouse @@y
underfed	under @@fed
commercialism	commercial @@ism
tobacco	tobacco
rawly	raw @@ly
verso	verso
worrying	worrying
unlikely	un @@likely
harvester	harvest @@er
toil	toil
sunbather	sunbathe @@er
mutably	mutable @@ly
indiscernible	in @@discernible
incorrect	in @@correct
swordsmanship	swordsman @@ship
goddess	god @@ess
rusticity	rustic @@ity
materialistic	materialist @@ic
priggishness	priggish @@ness
probability	probable @@ity
humanistic	humanist @@ic
jobber	job @@er
emptiness	empty @@ness
retractable	retract @@able
millionfold	millionfold
disgorge	dis @@gorge
sleigh	sleigh
unanswered	un @@answered
scamper	scamper
reliably	reliable @@ly
extemporaneousness	extemporaneous @@ness
rudimentary	rudiment @@ary
fairness	fair @@ness
surprising	surprising
celibacy	celibate @@cy
dredge	dredge
degree	degree
carbuncle	carbuncle
stoolie	stool @@ie
booziness	boozy @@ness
meagreness	meagre @@ness
misanthropist	misanthrope @@ist
sensory	sense @@ory
vet	vet
rustiness	rusty @@ness
condition	condition
hollowness	hollow @@ness
cravat	cravat
sensitivity	sensitive @@ity
flabbergast	flabbergast
cistern	cistern
distributional	distribution @@al
spoiler	spoil @@er
triteness	trite @@ness
premise	premise
flame	flame
keeps	keep @@s
singable	sing @@able
cock	cock
undoing	undoing
gaudily	gaudy @@ly
wainscoted	wainscot @@ed
daiquiri	daiquiri
decolonization	decolonize @@ation
dangle	dangle
perspicuity	perspicuous @@ity
vein	vein
lathery	lather @@y
despot	despot
taxability	taxable @@ity
trucking	truck @@ing
explorative	exploration @@ive
poplar	poplar
girdle	girdle
stiffly	stiff @@ly
rehabilitation	rehabilitate @@ion
dependability	dependable @@ity
observation	observe @@ation
contiguousness	contiguous @@ness
slickly	slick @@ly
hush	hush
tenthly	tenth @@ly
puerperal	puerperium @@al
crabbed	crabbed
skew	skew
thievery	thief @@ery
fundamentally	fundamental @@ly
huskily	husky @@ly
purebred	purebred
shakiness	shaky @@ness
schizophrenic	schizophrenia @@ic
discourse	dis @@course
hebdomadally	hebdomadal @@ly
ammo	ammunition
must	must
organized	organized
professed	professed
mastication	masticate @@ion
derivative	derivation @@ive
limitlessly	limitless @@ly
thickness	thick @@ness
splits	splits
doer	do @@er
makeshift	makeshift
comment	comment
quantitatively	quantitative @@ly
diversity	diverse @@ity
tailor	tailor
verbosity	verbose @@ity
terminus	terminus
blackberrying	blackberry @@ing
burdensome	burden @@some
caterwaul	caterwaul
streamlined	streamlined
slippy	slip @@y
stapler	staple @@er
functionalist	functionalist
bismuth	bismuth
inanimately	inanimate @@ly
leguminous	legume @@ous
component	component
inconceivable	in @@conceivable
bequest	be @@quest
retail	retail
deputize	deputy @@ize
raver	rave @@er
stodge	stodge
inaugural	in @@augur @@al
yew	yew
rehash	re @@hash
warder	ward @@er
exceptional	exception @@al
ghoulishness	ghoulish @@ness
larboard	larboard
flakiness	flaky @@ness
tacky	tack @@y
portly	port @@ly
statistics	statistics
trestle	trestle
gastronomically	gastronomic @@ally
faintly	faint @@ly
japonica	japonica
tamale	tamale
boggle	boggle
commendation	commend @@ation
imperturbably	imperturbable @@ly
emollient	emollient
silicone	silicone
overgrown	over @@grown
fundamentalist	fundamentalism @@ist
draughtsman	draught @@s @@man
twin	twin
blonde	blonde
myopic	myopia @@ic
zeppelin	zeppelin
gist	gist
slushy	slush @@y
unlimited	un @@limited
pantheist	pantheism @@ist
validate	valid @@ate
disruptively	disruptive @@ly
tearaway	tearaway
composite	composite
induction	induct @@ion
dogmatical	dogma @@ical
burr	burr
belligerence	belligerent @@ence
allowably	allowable @@ly
importunately	importunate @@ly
beard	beard
economic	economy @@ic
exhibitionistic	exhibitionist @@ic
aperient	aperient
concisely	concise @@ly
resuscitation	resuscitate @@ion
pipe	pipe
nankeen	nankeen
palatable	palate @@able
cheerful	cheer @@ful
barely	bare @@ly
daydream	daydream
barbarously	barbarous @@ly
spray	spray
cork	cork
blabber	blab @@er
awry	awry
chaperon	chaperon
transship	trans @@ship
phrase	phrase
lancers	lancers
inviolability	inviolable @@ity
wildly	wild @@ly
alga	alga
mutton	mutton
vilify	vile @@ify
executive	execution @@ive
haphazardly	haphazard @@ly
adjudication	adjudicate @@ion
calligrapher	calligraphy @@er
voluntary	volunteer @@ary
eschatological	eschatology @@ical
nothingness	nothing @@ness
logarithmic	logarithm @@ic
assemblage	assemble @@age
diffusion	diffuse @@ion
trigger	trigger
peeress	peer @@ess
barricade	barricade
undemonstrative	un @@demonstrative
disorder	dis @@order
unavoidable	un @@avoidable
wantonly	wanton @@ly
fudge	fudge
copper	copper
rejig	re @@jig
onside	onside
crop	crop
benefactress	benefactor @@ess
bursary	bursar @@y
plasma	plasma
liquor	liquor
evil	evil
mutiny	mutiny
daunt	daunt
cold	cold
dumps	dumps
those	those
facilitation	facilitate @@ion
havoc	havoc
plentiful	plenty @@ful
womanliness	womanly @@ness
insolvent	in @@solvent
lobbyist	lobby @@ist
roamer	roam @@er
nicknack	nicknack
sickening	sickening
lease	lease
effectualness	effectual @@ness
wait	wait
taro	taro
pertinently	pertinent @@ly
dissolutely	dissolute @@ly
skywards	skyward @@s
alpinism	alpine @@ism
cymbalist	cymbal @@ist
constructiveness	constructive @@ness
thermionic	thermion @@ic
prerequisite	pre @@requisite
deception	deceive @@ion
kind	kind
additionally	additional @@ly
philanderer	philander @@er
west	west
atom	atom
scraps	scraps
breeze	breeze
nosher	nosh @@er
broadcaster	broadcast @@er
particularize	particular @@ize
curve	curve
much	much
loaded	loaded
spectacle	spectacle
doubtless	doubt @@less
conically	conical @@ly
junkie	junk @@ie
squat	squat
neighbour	neighbour
silliness	silly @@ness
dub	dub
bigotedly	bigoted @@ly
dance	dance
sneaking	sneaking
competitiveness	competitive @@ness
suck	suck
cream	cream
nous	nous
dishonour	dishonour
treacherous	treachery @@ous
simulated	simulated
mannerly	manner @@ly
powdery	powder @@y
edgily	edgy @@ly
inextricable	in @@extricable
carol	carol
ooze	ooze
admission	admit @@ion
cloth	cloth
ineligibility	ineligible @@ity
qualify	quality @@ify
within	with @@in
scamper	scamp @@er
threesome	three @@some
daintiness	dainty @@ness
asexuality	asexual @@ity
antique	antique
fusil	fusil
mellow	mellow
outrange	out @@range
dust	dust
thermostatic	thermostat @@ic
covetous	covet @@ous
rag	rag
marshal	marshal
loopy	loop @@y
usuriously	usurious @@ly
deserter	desert @@er
benefit	benefit
fuss	fuss
fractiously	fractious @@ly
convener	convene @@er
principled	principle @@ed
boohoo	boohoo
gritty	grit @@y
metropolitan	metropolitan
horn	horn
waddle	waddle
naturalist	naturalism @@ist
nineteenth	nineteen @@th
etcher	etch @@er
hope	hope
pluralism	plural @@ism
contestable	contest @@able
exhaustion	exhaust @@ion
silly	silly
gratifying	gratifying
health	heal @@th
cheer	cheer
paranoiacally	paranoiac @@ally
uprightness	upright @@ness
assegai	assegai
indiscreetly	indiscreet @@ly
doddery	dodder @@y
continent	continent
intangibility	intangible @@ity
demagogue	demagogue
bud	bud
cosily	cosy @@ly
perry	perry
boob	boob
old	old
post	post
nonproliferation	non @@proliferation
outbrave	out @@brave
culottes	culotte @@s
admirer	admire @@er
tearing	tearing
desperado	desperado
smooch	smooch
titillation	titillate @@ion
miner	mine @@er
logicality	logical @@ity
caginess	cagey @@ness
divan	divan
wielder	wield @@er
ignorant	ignore @@ant
recess	recess
mirthfully	mirthful @@ly
raceme	raceme
geometrical	geometry @@ical
busby	busby
syndicalism	syndical @@ism
regionally	regional @@ly
shudder	shudder
comeliness	comely @@ness
flounce	flounce
storm	storm
collective	collection @@ive
almond	almond
goer	go @@er
entangle	en @@tangle
sojourn	sojourn
outcaste	out @@caste
nonrestrictive	non @@restrictive
commendatory	commendation @@ory
low	low
soundness	sound @@ness
pasturage	pasture @@age
largeness	large @@ness
overawe	over @@awe
abhorrence	abhorrent @@ence
diverting	diverting
apple	apple
transcription	transcribe @@ion
exhalation	exhale @@ation
autumn	autumn
bonesetter	bone @@set @@er
percentage	percent @@age
ebullience	ebullient @@ence
quarrelsome	quarrel @@some
player	play @@er
buoyantly	buoyant @@ly
disbeliever	disbelieve @@er
weirdly	weird @@ly
canoeist	canoe @@ist
habitable	habitation @@able
related	related
affected	affected
muscled	muscle @@ed
blinder	blind @@er
dolefully	doleful @@ly
foal	foal
startlingly	startling @@ly
bombastically	bombastic @@ally
childish	child @@ish
brawniness	brawny @@ness
curative	curative
amalgamation	amalgamate @@ion
brevity	brief @@ity
prenatally	prenatal @@ly
innocence	innocent @@ence
fucker	fuck @@er
centrifugal	centrifuge @@al
toady	toady
seductively	seductive @@ly
snap	snap
snappily	snappy @@ly
coolant	cool @@ant
backbiter	backbite @@er
harrier	harry @@er
insert	insert
punchiness	punchy @@ness
pearliness	pearly @@ness
growth	grow @@th
delft	delft
overload	overload
day	day
deceit	deceit
sawyer	saw @@er
attach	attach
reproachful	reproach @@ful
smirch	smirch
dwelling	dwelling
nab	nab
seventeenth	seventeen @@th
appro	approval
indefinably	indefinable @@ly
lifeless	life @@less
peaty	peat @@y
nebula	nebula
louse	louse
ancestral	ancestor @@al
browse	browse
winning	winning
snuffles	snuffles
antithetically	antithetical @@ly
dreaded	dreaded
sporting	sporting
diagonal	diagonal
plough	plough
better	better
dudgeon	dudgeon
moisten	moist @@en
enunciation	enunciate @@ion
mildness	mild @@ness
castle	castle
graspingly	grasping @@ly
saxifrage	saxifrage
worth	worth
call	call
tunnel	tunnel
powerlessly	powerless @@ly
net	net
bracing	bracing
factor	factor
demerara	demerara
eyelet	eye @@let
pecuniarily	pecuniary @@ly
standoffish	stand @@off @@ish
homosexuality	homosexual @@ity
downtown	downtown
shit	shit
transmitter	transmit @@er
hypothetical	hypothesis @@ical
deforest	de @@forest
solitarily	solitary @@ly
portrait	portrait
unnecessarily	unnecessary @@ly
largely	large @@ly
barouche	barouche
stow	stow
broccoli	broccoli
judo	judo
excruciatingly	excruciating @@ly
mandragora	mandragora
twerp	twerp
incarnation	incarnate @@ion
preclusion	preclude @@ion
allied	allied
chalkiness	chalky @@ness
abysmally	abysmal @@ly
allopathical	allopathy @@ical
causal	cause @@al
sectarianism	sectarian @@ism
serpent	serpent
doctrinal	doctrine @@al
draconian	Draco @@ian
sniffles	sniffles
condescension	condescend @@ion
rummy	rummy
pageant	pageant
delirious	delirium @@ous
infatuate	in @@fatuous @@ate
incomplete	in @@complete
feeder	feed @@er
garishness	garish @@ness
broaden	broad @@en
offices	offices
calve	calf
recount	re @@count
awkwardness	awkward @@ness
homogeneously	homogeneous @@ly
lucid	lucid
rollicking	rollicking
pox	pox
wreck	wreck
enviable	envy @@able
tote	tote
humdrum	humdrum
atrocity	atrocious @@ity
fiance	fiance
caliphate	caliph @@ate
misinterpretation	misinterpret @@ation
antibiotically	antibiotic @@ally
southeaster	southeast @@er
radial	radius @@al
cohesively	cohesive @@ly
reinstate	re @@instate
rung	rung
bureau	bureau
euphemistically	euphemistic @@ally
preternaturally	preternatural @@ly
vitrify	vitric @@ify
laugh	laugh
commissary	commit @@ary
condenser	condense @@er
riveting	riveting
sac	sac
vomit	vomit
lands	lands
chimerically	chimerical @@ly
indignantly	indignant @@ly
knowingly	knowing @@ly
portraitist	portrait @@ist
impassioned	impassioned
bumper	bump @@er
shred	shred
residuary	residue @@ary
careerist	career @@ist
inactively	inactive @@ly
disunion	dis @@union
drummer	drum @@er
funerary	funeral @@ary
bats	bats
transmutation	transmute @@ation
whine	whine
geographer	geography @@er
hartebeest	hartebeest
silently	silent @@ly
ticking	tick @@ing
incarceration	incarcerate @@ion
inopportunely	inopportune @@ly
hybrid	hybrid
limbless	limb @@less
like	like
snugness	snug @@ness
nonsmoker	non @@smoker
reminiscences	reminiscences
committed	committed
archaism	archaic @@ism
wonder	wonder
pinstriped	pinstripe @@ed
travels	travels
complement	complement
retroactively	retroactive @@ly
elusory	elusion @@ory
authority	author @@ity
benevolently	benevolent @@ly
crate	crate
excitedly	excited @@ly
jujitsu	jujitsu
rocket	rocket
brandy	brandy
spatially	spatial @@ly
marsh	marsh
undersign	under @@sign
gory	gore @@y
rapist	rape @@ist
expropriator	expropriate @@or
grafter	graft @@er
movable	move @@able
chatterer	chatter @@er
filmy	film @@y
slut	slut
friendlessness	friendless @@ness
despicably	despicable @@ly
diploma	diploma
eightieth	eighty @@th
strip	strip
format	format
iambic	iamb @@ic
fidgets	fidget @@s
gilding	gilding
felon	felon
overdevelop	over @@develop
disinclined	disinclined
nudist	nudist
lazy	laze @@y
mimic	mimic
extemporization	extemporize @@ation
hyphenation	hyphenate @@ion
relatively	relative @@ly
uselessly	useless @@ly
indiscreet	in @@discreet
egotism	ego @@ism
creosote	creosote
tonic	tonic
symbolist	symbolism @@ist
adversity	adverse @@ity
demonstration	demonstrate @@ion
pram	perambulator
reviser	revise @@er
wood	wood
matting	matting
totality	total @@ity
bearing	bearing
unutterable	un @@utterable
cellarage	cellar @@age
conventional	convention @@al
wen	wen
tiring	tiring
methodologically	methodological @@ly
topper	top @@er
aesthetical	aesthete @@ical
backer	back @@er
cringe	cringe
flagellant	flagellate @@ant
overshot	over @@shot
sepulchre	sepulchre
hack	hack
previously	previous @@ly
skimpily	skimpy @@ly
beseechingly	beseeching @@ly
glutton	glutton
theft	theft
holidaymaker	holiday @@make @@er
reproof	reproof
pretended	pretended
relive	re @@live
lyceum	lyceum
doubtful	doubt @@ful
decay	decay
cheerfulness	cheerful @@ness
probing	probing
repossession	repossess @@ion
tousle	tousle
spasmodical	spasm @@ical
explicitly	explicit @@ly
deathly	deathly
implication	imply @@ation
exploded	exploded
reincarnate	reincarnate
trace	trace
spicily	spicy @@ly
elongate	e @@long @@ate
anachronistic	anachronism @@ic
decamp	de @@camp
horseshit	horseshit
reprint	reprint
wrist	wrist
theosophical	theosophy @@ical
nip	nip
outer	out @@er
infernally	infernal @@ly
rarely	rare @@ly
uninhibitedly	uninhibited @@ly
enzyme	enzyme
anthrax	anthrax
seventy	seven @@ty
verbal	verbal
cunnilinctus	cunnilinctus
mascot	mascot
slimly	slim @@ly
palliation	palliate @@ion
vertically	vertical @@ly
lightness	light @@ness
outplay	out @@play
ret	ret
continental	continent @@al
cryptical	crypt @@ical
candelabra	candelabra
overlong	over @@long
flaccid	flaccid
unreasonable	un @@reasonable
lubricant	lubricate @@ant
owl	owl
excitable	excite @@able
gentleness	gentle @@ness
recurve	re @@curve
carriage	carry @@age
untangle	un @@tangle
functionalist	functionalism @@ist
likely	likely
topaz	topaz
adviser	advise @@er
roadless	road @@less
vexation	vex @@ation
paddock	paddock
jejunely	jejune @@ly
immutability	immutable @@ity
haver	haver
tunefulness	tuneful @@ness
glint	glint
derequisition	de @@requisition
cove	cove
maiden	maiden
pathological	pathology @@ical
unstop	un @@stop
calculably	calculable @@ly
refutation	refute @@ation
hobnailed	hobnail @@ed
expertness	expert @@ness
reviler	revile @@er
ineffectively	ineffective @@ly
heave	heave
secure	secure
youthfully	youthful @@ly
ambitiously	ambitious @@ly
inextricably	inextricable @@ly
expensively	expensive @@ly
inverse	inverse
leash	leash
cater	cater
archery	archer @@ery
prone	prone
specimen	specimen
ghost	ghost
irreconcilably	irreconcilable @@ly
uncertainly	uncertain @@ly
muggins	muggins
kibosh	kibosh
slavishly	slavish @@ly
tireless	tire @@less
lock	lock
transitively	transitive @@ly
characterization	characterize @@ation
curtly	curt @@ly
mineralogist	mineralogy @@ist
woollen	wool @@en
guilelessly	guileless @@ly
damning	damning
viciously	vicious @@ly
scholarly	scholar @@ly
brad	brad
parliamentary	parliament @@ary
motorcyclist	motorcycle @@ist
monolithically	monolithic @@ally
trillionth	trillion @@th
fulsomeness	fulsome @@ness
totally	total @@ly
flax	flax
easily	easy @@ly
incommensurable	in @@commensurable
stucco	stucco
sucrose	sucrose
knotty	knot @@y
loathsomeness	loathsome @@ness
untutored	un @@tutored
compassionately	compassionate @@ly
rotter	rot @@er
engulf	en @@gulf
garrison	garrison
apocalyptic	apocalypse @@ic
brief	brief
halberdier	halberd @@ier
manhood	man @@hood
mistime	mis @@time
unwilling	un @@willing
moth	moth
depressingly	depressing @@ly
distinction	distinct @@ion
reword	re @@word
chairmanship	chairman @@ship
boaster	boast @@er
cud	cud
bilateralism	bilateral @@ism
recentness	recent @@ness
solo	solo
integrate	integer @@ate
betwixt	betwixt
tensely	tense @@ly
transmigration	transmigrate @@ion
exhilarating	exhilarating
decision	decide @@ion
crucially	crucial @@ly
ordination	ordain @@ation
persuasion	persuade @@ion
jumper	jump @@er
battleship	battle @@ship
melon	melon
flightless	flight @@less
illumine	illumine
sis	sister
starless	star @@less
confectioner	confection @@er
encircle	en @@circle
incommunicable	in @@communicable
antecedence	antecedent @@ence
tepidity	tepid @@ity
jangle	jangle
soundings	sounding @@s
mizzen	mizzen
refuse	refuse
bewail	be @@wail
trample	trample
undermine	under @@mine
egoist	egoism @@ist
puff	puff
percipience	percipient @@ence
goodnight	goodnight
provincially	provincial @@ly
fullness	full @@ness
obliteration	obliterate @@ion
offertory	offer @@ory
decorously	decorous @@ly
bolero	bolero
blackguard	blackguard
gladiatorial	gladiator @@ial
chick	chick
datum	datum
debut	debut
con	con
preserver	preserve @@er
cod	cod
classic	classic
swipe	swipe
polygamist	polygamy @@ist
twirl	twirl
instruction	instruct @@ion
long	long
containerize	container @@ize
functional	function @@al
pertinacity	pertinacious @@ity
recharge	re @@charge
seriously	serious @@ly
sideslip	sideslip
incidentals	incidentals
chirpiness	chirpy @@ness
metricate	metric @@ate
soothe	soothe
correspondingly	corresponding @@ly
floor	floor
polysyllabically	polysyllabic @@ally
wheezy	wheeze @@y
coastwise	coastwise
deuced	deuce @@ed
boar	boar
typographer	typography @@er
insensitively	insensitive @@ly
solver	solve @@er
absence	absent @@ence
niggler	niggle @@er
toucan	toucan
wrongheaded	wrong @@head @@ed
answer	answer
elaboration	elaborate @@ion
county	count @@y
latinize	Latin @@ize
downrightness	downright @@ness
grumbling	grumbling
retrieval	retrieve @@al
maidenlike	maiden @@like
toddler	toddle @@er
fauna	fauna
beguilingly	beguiling @@ly
disreputably	disreputable @@ly
shipboard	ship @@board
generative	generation @@ive
wetting	wetting
discard	discard
eurhythmy	eurhythmy
violently	violent @@ly
teachable	teach @@able
ceremoniously	ceremonious @@ly
soberly	sober @@ly
healthful	health @@ful
custodial	custody @@al
sardine	sardine
difficult	difficult
tripper	trip @@er
compare	compare
fortnightly	fortnight @@ly
nomadically	nomadic @@ally
achieve	achieve
gospel	gospel
rubberneck	rubberneck
factually	factual @@ly
perplexity	perplex @@ity
ballistics	ballistic @@s
talus	talus
paternalistically	paternalistic @@ally
snootily	snooty @@ly
mandolin	mandolin
libido	libido
octave	octave
enkindle	en @@kindle
mismanage	mis @@manage
intractable	in @@tractable
soil	soil
infatuated	infatuated
amends	amend @@s
effectives	effective @@s
raft	raft
sightless	sight @@less
equip	equip
mercurially	mercurial @@ly
deacon	deacon
stigmatize	stigma @@ize
timidness	timid @@ness
hungrily	hungry @@ly
admonishing	admonishing
summarily	summary @@ly
pricking	pricking
mulct	mulct
hoe	hoe
nebulosity	nebulous @@ity
curtain	curtain
immediately	immediately
sleety	sleet @@y
chug	chug
slavey	slave @@y
barracks	barracks
pennant	pennant
genuinely	genuine @@ly
idiotic	idiot @@ic
clumsily	clumsy @@ly
effeteness	effete @@ness
bundle	bundle
metallurgical	metallurgy @@ical
squarely	square @@ly
indistinguishably	indistinguishable @@ly
fuck	fuck
possibly	possible @@ly
manned	manned
nth	n @@th
laudability	laudable @@ity
dew	dew
phoney	phoney
joyfulness	joyful @@ness
obliquely	oblique @@ly
scarify	scar @@ify
loudmouthed	loudmouth @@ed
shelf	shelf
finding	finding
rodent	rodent
respond	respond
obsessive	obsessive
canon	canon
widgeon	widgeon
westwards	westward @@s
camping	camping
attractive	attraction @@ive
lyric	lyric
octagonal	octagon @@al
criminal	criminal
quizzically	quizzical @@ly
gob	gob
crimson	crimson
trusteeship	trustee @@ship
symbolism	symbol @@ism
divination	divine @@ation
proverbial	proverb @@ial
double	double
ethically	ethical @@ly
fillet	fillet
barm	barm
overtly	overt @@ly
whippy	whip @@y
acclimatization	acclimatize @@ation
advisable	advise @@able
negotiation	negotiate @@ion
header	head @@er
impact	impact
mechanistic	mechanism @@ic
malevolence	malevolent @@ence
jaunt	jaunt
fiercely	fierce @@ly
plastics	plastic @@s
stringently	stringent @@ly
painter	paint @@er
participant	participate @@ant
sable	sable
wind	wind
plaster	plaster
prospector	prospect @@or
fortieth	fortieth
authoress	author @@ess
irregular	irregular
saline	salt @@ine
indestructibly	indestructible @@ly
joylessly	joyless @@ly
disconcertingly	disconcerting @@ly
coxswain	coxswain
acquisitively	acquisitive @@ly
laxative	laxative
snuffer	snuff @@er
safeness	safe @@ness
chicle	chicle
boner	bone @@er
unruliness	unruly @@ness
speciousness	specious @@ness
downhill	downhill
gropingly	grope @@ing @@ly
drover	drove @@er
purr	purr
merge	merge
permissiveness	permissive @@ness
muddiness	muddy @@ness
pace	pace
mark	mark
immensely	immense @@ly
guiltless	guilt @@less
callosity	callous @@ity
bestowal	bestow @@al
jig	jig
substantiation	substantiate @@ion
darkness	dark @@ness
rotary	rotary
replace	re @@place
pliancy	pliant @@ancy
speculative	speculation @@ive
grudging	grudging
interchange	interchange
incongruity	incongruous @@ity
bloated	bloated
turner	turn @@er
pull	pull
asthma	asthma
ready	ready
fibula	fibula
repeat	repeat
cuirass	cuirass
racist	racist
subordination	subordinate @@ion
snobby	snob @@y
westerner	western @@er
dixie	dixie
boisterousness	boisterous @@ness
illuminations	illuminations
prod	prod
surpliced	surplice @@ed
laurelled	laurel @@ed
inalienable	in @@alienable
dobbin	dobbin
easel	easel
pith	pith
kedgeree	kedgeree
pacifist	pacifism @@ist
inattentiveness	inattentive @@ness
spuriousness	spurious @@ness
step	step
orders	orders
abstruseness	abstruse @@ness
irresponsibly	irresponsible @@ly
mitre	mitre
munificence	munificent @@ence
fustiness	fusty @@ness
coiffured	coiffure @@ed
inedibly	inedible @@ly
barn	barn
approval	approve @@al
remould	re @@mould
mistake	mistake
burn	burn
thickening	thickening
sliver	sliver
beefy	beef @@y
john	john
torridly	torrid @@ly
breathily	breathy @@ly
toughie	tough @@ie
scallop	scallop
prescriptive	prescription @@ive
horsemanship	horseman @@ship
disinfect	dis @@infect
few	few
stowage	stow @@age
pharisee	pharisee
bury	bury
retriever	retrieve @@er
dampish	damp @@ish
interpose	inter @@pose
taper	taper
jittery	jitters @@y
photo	photograph
toupee	toupee
woman	woman
microfilm	microfilm
brashly	brash @@ly
deflation	deflate @@ion
inviolable	in @@violable
notification	notify @@ation
intimidation	intimidate @@ion
superficiality	superficial @@ity
sassy	sass @@y
juice	juice
mistrust	mistrust
limited	limited
resolve	resolve
recallable	recall @@able
client	client
glue	glue
deplane	de @@plane
demonstrably	demonstrable @@ly
sculptor	sculpt @@or
impressiveness	impressive @@ness
citron	citron
knout	knout
cluck	cluck
warmth	warm @@th
tinter	tint @@er
sorrow	sorrow
eventfulness	eventful @@ness
indeed	in @@deed
graft	graft
menace	menace
crackle	crackle
dugong	dugong
aphasic	aphasia @@ic
alternator	alternate @@or
petition	petition
undershirt	under @@shirt
hair	hair
indirectness	indirect @@ness
oxidization	oxidize @@ation
genially	genial @@ly
semen	semen
worrisome	worry @@some
sometimes	some @@times
squeal	squeal
teeth	teeth
eleven	eleven
also	also
insignificant	in @@significant
developmentally	developmental @@ly
molasses	molasses
pauperism	pauper @@ism
spectacularly	spectacular @@ly
impecuniousness	impecunious @@ness
commonness	common @@ness
spinet	spinet
convulsion	convulse @@ion
gloweringly	glower @@ing @@ly
creel	creel
chipping	chip @@ing
stationer	station @@er
haze	haze
discourteously	discourteous @@ly
gang	gang
raptly	rapt @@ly
murky	murk @@y
gentian	gentian
affirmative	affirmation @@ive
thrum	thrum
writhe	writhe
condescending	condescending
upmost	upmost
comfort	comfort
honorific	honorific
extremities	extremities
ineffably	ineffable @@ly
corrective	correction @@ive
hubbub	hubbub
indecorum	in @@decorum
definable	define @@able
waffle	waffle
iconoclastic	iconoclast @@ic
impotently	impotent @@ly
coincidence	coincident @@ence
horrify	horror @@ify
clarify	clear @@ify
heckle	heckle
conclave	conclave
negus	negus
wearable	wear @@able
partitively	partitive @@ly
buggery	bugger @@ery
sottishly	sottish @@ly
symbolic	symbol @@ic
erection	erect @@ion
unerringly	unerring @@ly
remedially	remedial @@ly
devilishly	devilish @@ly
drubbing	drubbing
preciously	precious @@ly
stylistic	stylist @@ic
burg	burg
adoringly	adoring @@ly
shits	shits
modelling	modelling
sail	sail
outlay	outlay
clique	clique
triad	triad
idem	idem
proconsulate	proconsul @@ate
inarticulately	inarticulate @@ly
sombreness	sombre @@ness
scrupulousness	scrupulous @@ness
automatically	automatic @@ally
jocosely	jocose @@ly
revenue	revenue
appropriately	appropriate @@ly
intactness	intact @@ness
indifference	indifferent @@ence
bounds	bounds
loverlike	lover @@like
undeceive	un @@deceive
purposeless	purpose @@less
geocentric	geo @@centre @@ic
index	index
connective	connective
archaeological	archaeology @@ical
academic	academy @@ic
hesitation	hesitate @@ion
horse	horse
tight	tight
grievous	grief @@ous
respect	respect
adoptive	adoption @@ive
will	will
indexer	index @@er
spindle	spindle
sensor	sense @@or
plunk	plunk
legato	legato
obstructionist	obstructionism @@ist
proportionable	proportion @@able
most	most
sharpshooter	sharp @@shoot @@er
prostrate	prostrate
father	father
northeast	northeast
crazed	crazed
salad	salad
frond	frond
indulgently	indulgent @@ly
intestate	in @@testate
desultorily	desultory @@ly
flagellation	flagellate @@ion
neap	neap
gird	gird
broadmindedness	broadminded @@ness
vitalization	vitalize @@ation
lesser	less @@er
gastronomic	gastronomy @@ic
wholesaler	wholesale @@er
wriggler	wriggle @@er
couth	couth
defendant	defend @@ant
doubt	doubt
lawfulness	lawful @@ness
confidently	confident @@ly
safe	safe
acrimonious	acrimony @@ous
quaintly	quaint @@ly
renewal	renew @@al
apprehension	apprehend @@ion
disobligingly	disobliging @@ly
bisection	bisect @@ion
rendezvous	rendezvous
plucky	pluck @@y
expedient	expedient
stagnantly	stagnant @@ly
efficacious	efficacy @@ous
internationalize	international @@ize
nail	nail
illegibility	illegible @@ity
twinkle	twinkle
flabbiness	flabby @@ness
flying	flying
resinate	resin @@ate
biretta	biretta
shininess	shiny @@ness
thicken	thick @@en
mercilessly	merciless @@ly
measliness	measly @@ness
signification	signify @@ation
otherwise	other @@wise
pear	pear
genus	genus
frankly	frank @@ly
dynamite	dynamic @@ite
enlist	en @@list
flutter	flutter
falsies	false @@ie @@s
luckless	luck @@less
refractory	refract @@ory
chauffeur	chauffeur
penalize	penal @@ize
heaviness	heavy @@ness
interpreter	interpret @@er
recuperation	recuperate @@ion
sociologically	sociological @@ly
ability	able @@ity
dumbly	dumb @@ly
hurtfully	hurtful @@ly
modestly	modest @@ly
sloe	sloe
blithesome	blithe @@some
shepherdess	shepherd @@ess
kindle	kindle
bolt	bolt
intensely	intense @@ly
such	such
sureness	sure @@ness
woof	woof
tonal	tone @@al
assumption	assume @@ion
tallow	tallow
aerobatics	aerobatic @@s
twofaced	two @@face @@ed
blond	blond
evergreen	evergreen
acrimoniously	acrimonious @@ly
formalism	formal @@ism
assail	assail
rattler	rattle @@er
intumescence	intumescent @@ence
devastatingly	devastating @@ly
featherweight	featherweight
downstream	downstream
oven	oven
sedately	sedate @@ly
done	done
stalemate	stalemate
futurist	futurism @@ist
tram	tram
slob	slob
insane	in @@sane
egoistically	egoistical @@ly
advisory	advise @@ory
jealously	jealous @@ly
pillager	pillage @@er
ashamed	a @@shame @@ed
games	games
char	char
normal	norm @@al
improvidently	improvident @@ly
depilatory	depilatory
artifact	artifact
varied	varied
pointed	pointed
testate	testate
porpoise	porpoise
kurus	kurus
becoming	becoming
temper	temper
ruins	ruins
instrumental	instrument @@al
inscrutability	inscrutable @@ity
carnivorous	carnivore @@ous
aesthetically	aesthetic @@ally
debunker	debunk @@er
distributor	distribute @@or
viable	viable
innocently	innocent @@ly
wheat	wheat
stammer	stammer
illicitly	illicit @@ly
breathtakingly	breathtaking @@ly
uninhibited	un @@inhibited
wordless	word @@less
megalithic	megalith @@ic
drollness	droll @@ness
heartlessly	heartless @@ly
complicatedness	complicated @@ness
extensively	extensive @@ly
boast	boast
aphid	aphid
shrift	shrift
decompress	de @@compress
lankness	lank @@ness
roaring	roaring
rug	rug
metaphorically	metaphorical @@ly
question	question
mannerism	manner @@ism
fetter	fetter
reticulation	reticulate @@ion
film	film
killingly	killing @@ly
tiller	till @@er
sublime	sublime
pointer	point @@er
fencer	fence @@er
nonwhite	non @@white
deviousness	devious @@ness
cannibal	cannibal
accommodation	accommodate @@ion
prey	prey
catastrophe	catastrophe
nipper	nip @@er
twirler	twirl @@er
postal	post @@al
medicine	medic @@ine
persevering	persevering
restrictively	restrictive @@ly
yaw	yaw
assassination	assassinate @@ion
console	console
cervical	cervix @@al
carafe	carafe
healthiness	healthy @@ness
cinnamon	cinnamon
pet	pet
maths	mathematics
quantifiable	quantify @@able
wedge	wedge
jumble	jumble
wizard	wizard
wakeful	wake @@ful
respectability	respectable @@ity
counterfeiter	counterfeit @@er
hide	hide
interim	interim
widely	wide @@ly
adamantine	adamant @@ine
savage	savage
convent	convent
lowness	low @@ness
paroxysm	paroxysm
equalitarian	equalitarian
unwritten	un @@written
hypnotist	hypnotism @@ist
prostration	prostrate @@ion
elimination	eliminate @@ion
unscripted	un @@scripted
fractiousness	fractious @@ness
paleographically	paleographic @@ally
boiler	boil @@er
khaki	khaki
delimitate	de @@limit @@ate
disappointingly	disappointing @@ly
leopardess	leopard @@ess
desecrate	de @@consecrate
uncomfortable	un @@comfortable
risky	risk @@y
flannel	flannel
dynast	dynast
suppressiveness	suppressive @@ness
missus	missus
outline	out @@line
dalmatian	Dalmatia @@an
ambivalence	ambivalent @@ence
moonless	moon @@less
tench	tench
severely	severe @@ly
council	council
swag	swag
heartlessness	heartless @@ness
flaccidity	flaccid @@ity
grandiloquence	grandiloquent @@ence
closefisted	close @@fist @@ed
ashen	ash @@en
capsule	capsule
employee	employ @@ee
cheekily	cheeky @@ly
ewe	ewe
soundly	sound @@ly
banker	bank @@er
jag	jag
timpani	timpani
undivided	un @@divided
christening	christening
breach	breach
electromagnetic	electromagnet @@ic
contradiction	contradict @@ion
formalist	formalism @@ist
uniformed	uniform @@ed
rookery	rook @@ery
weekend	weekend
alternate	alternate
faddishly	faddish @@ly
plumbing	plumbing
roneo	Roneo
liberally	liberal @@ly
fordable	ford @@able
posit	posit
facer	face @@er
monopolistically	monopolistic @@ally
freshen	fresh @@en
brothel	brothel
exemplify	example @@ify
apostate	apostasy @@ate
goddam	goddam
exasperatedly	exasperated @@ly
hyperbolic	hyperbola @@ic
frown	frown
present	present
dodger	dodge @@er
dread	dread
inconsiderable	in @@considerable
strikingly	striking @@ly
noiselessness	noiseless @@ness
humbug	humbug
linnet	linnet
fraught	fraught
convenience	convenient @@ence
incommodiously	incommodious @@ly
uninterested	un @@interested
realtor	realty @@or
briar	briar
chemically	chemical @@ly
facilely	facile @@ly
gosling	goose @@ling
executioner	execution @@er
delinquent	delinquent
renunciation	renounce @@ation
voluptuary	voluptuous @@ary
huff	huff
terminal	terminus @@al
insularity	insular @@ity
bazooka	bazooka
team	team
unobtrusiveness	unobtrusive @@ness
whereat	whereat
disguise	disguise
epileptic	epilepsy @@ic
northwesterly	northwest @@ly
enable	en @@able
sportive	sport @@ive
fledge	fledge
instigator	instigate @@or
forewoman	fore @@woman
swelter	swelter
yachtswoman	yacht @@s @@woman
horny	horn @@y
infamous	infamy @@ous
inflexibly	inflexible @@ly
unexceptionably	unexceptionable @@ly
gaily	gay @@ly
closet	closet
bairn	bairn
undress	un @@dress
phenomenally	phenomenal @@ly
ransom	ransom
contrariness	contrary @@ness
bucketful	bucket @@ful
consequentially	consequential @@ly
wolfsbane	wolf @@s @@bane
pig	pig
incremental	increment @@al
biographically	biographical @@ly
lint	lint
equivocation	equivocate @@ion
sharply	sharp @@ly
unionize	union @@ize
stoep	stoep
subconsciousness	subconscious @@ness
fancifully	fanciful @@ly
inattentively	inattentive @@ly
repression	repress @@ion
conduciveness	conducive @@ness
racily	racy @@ly
flagrancy	flagrant @@ancy
condemn	condemn
wallow	wallow
defencelessly	defenceless @@ly
determinism	determine @@ism
gent	gent
unmask	un @@mask
strainer	strain @@er
partita	partita
bop	bebop
flannels	flannels
exemplary	example @@ary
potentiality	potential @@ity
slackness	slack @@ness
brick	brick
skint	skint
asbestos	asbestos
lank	lank
controller	control @@er
plasterer	plaster @@er
unpleasant	un @@pleasant
vaporization	vaporize @@ation
tenderize	tender @@ize
drench	drench
insipid	insipid
entreaty	entreat @@y
palaver	palaver
tope	tope
bacchanalian	bacchanal @@ian
cadger	cadge @@er
masterless	master @@less
forbearing	forbearing
sufficiently	sufficient @@ly
without	with @@out
significant	signify @@ant
discontent	discontent
redden	red @@en
incompatibility	incompatible @@ity
uselessness	useless @@ness
ladder	ladder
weightlessness	weightless @@ness
aerodynamically	aerodynamic @@ally
auditory	audition @@ory
reticulated	reticulated
arduously	arduous @@ly
reformer	reform @@er
parentage	parent @@age
shear	shear
felucca	felucca
purposely	purpose @@ly
lemur	lemur
lectureship	lecture @@ship
accession	accede @@ion
euphoric	euphoria @@ic
complacence	complacent @@ence
vacuity	vacuous @@ity
grouchiness	grouchy @@ness
pang	pang
salivation	salivate @@ion
actuate	act @@ate
anarchical	anarchy @@ical
freehanded	free @@hand @@ed
marzipan	marzipan
selector	select @@or
glide	glide
hit	hit
mongoose	mongoose
thankfully	thankful @@ly
malapropism	Malaprop @@ism
duenna	duenna
accord	accord
fewer	few @@er
squirrel	squirrel
cutter	cut @@er
luck	luck
prudence	prudent @@ence
snowiness	snowy @@ness
ponderables	ponderable @@s
parer	pare @@er
still	still
sateen	sateen
defeatist	defeatism @@ist
pitcher	pitch @@er
hennaed	henna @@ed
compliant	comply @@ant
zee	zee
freeload	free @@load
disdainfully	disdainful @@ly
beat	beat
mortise	mortise
optional	option @@al
psychotically	psychotic @@ally
freelance	free @@lance
fetching	fetching
ventilator	ventilate @@or
paperhanger	paper @@hang @@er
bruiser	bruise @@er
itchiness	itchy @@ness
horsewhip	horsewhip
cairn	cairn
incapably	incapable @@ly
tannic	tannin @@ic
tenet	tenet
orange	orange
incorrigible	in @@corrigible
anaesthetist	anaesthesia @@ist
unsyllabic	un @@syllabic
grocery	grocer @@ery
assay	assay
lantern	lantern
schnorkel	schnorkel
servery	serve @@ery
fort	fort
kip	kip
statics	static @@s
tanner	tan @@er
arena	arena
pekoe	pekoe
scenarist	scenario @@ist
daemon	daemon
thank	thank
bobs	bob @@s
recitation	recite @@ation
papyrus	papyrus
compilation	compile @@ation
ballooning	balloon @@ing
disafforest	dis @@afforest
disavowal	disavow @@al
mooch	mooch
mire	mire
regretful	regret @@ful
cleanly	clean @@ly
neighbourly	neighbour @@ly
bazaar	bazaar
astutely	astute @@ly
surprisedly	surprised @@ly
albumen	albumen
unbecoming	un @@becoming
circumcision	circumcise @@ion
tee	tee
bookmaker	book @@make @@er
trafficker	traffic @@er
phantasmic	phantasm @@ic
pommel	pommel
grossness	gross @@ness
isolationism	isolation @@ism
flour	flour
interpolation	interpolate @@ion
career	career
licensee	license @@ee
malignant	malign @@ant
opulence	opulent @@ence
typographical	typography @@ical
surefootedly	surefooted @@ly
pile	pile
responsiveness	responsive @@ness
semolina	semolina
detour	detour
corsair	corsair
minimally	minimal @@ly
conformation	conform @@ation
interaction	interact @@ion
item	item
infract	infract
tamarisk	tamarisk
acidic	acid @@ic
gravity	grave @@ity
spaciously	spacious @@ly
freehand	freehand
penetratingly	penetrating @@ly
potter	pot @@er
intermediate	intermediate
cockeyed	cock @@eye @@ed
vividness	vivid @@ness
rand	rand
band	band
inside	inside
washing	washing
collapse	collapse
smithy	smith @@y
creditable	credit @@able
ethnographic	ethnography @@ic
numeracy	numerate @@cy
cantankerously	cantankerous @@ly
pyrotechnic	pyrotechny @@ic
narky	nark @@y
germination	germinate @@ion
providently	provident @@ly
underfloor	under @@floor
remould	remould
furze	furze
attainable	attain @@able
expedition	expedite @@ion
foolhardy	fool @@hard @@y
foredoom	fore @@doom
auk	auk
energize	energy @@ize
annexation	annex @@ation
disendow	dis @@endow
majestical	majesty @@ical
dug	dug
claret	claret
crisply	crisp @@ly
amplify	ample @@ify
soccer	soccer
infestation	infest @@ation
trusting	trusting
branch	branch
impeachable	impeach @@able
diffidently	diffident @@ly
avail	avail
booster	boost @@er
lunch	lunch
quiet	quiet
ayah	ayah
cleaner	clean @@er
brotherliness	brotherly @@ness
proportionate	proportion @@ate
intimately	intimate @@ly
understaffed	under @@staffed
town	town
staggerer	stagger @@er
palate	palate
virologist	virology @@ist
sahib	sahib
foolishly	foolish @@ly
receipts	receipts
ness	ness
awkwardly	awkward @@ly
elusive	elusion @@ive
national	national
manumission	manumit @@ion
senses	senses
prehistorical	prehistory @@ical
rowdy	rowdy
pupation	pupate @@ion
maidenhood	maiden @@hood
shank	shank
appointed	appointed
leftward	leftward
affectionately	affectionate @@ly
modern	modern
notional	notion @@al
pigheaded	pig @@head @@ed
unequal	un @@equal
pyrites	pyrites
derogation	derogate @@ion
sleek	sleek
abrasion	abrade @@ion
lord	lord
ghastliness	ghastly @@ness
plenteousness	plenteous @@ness
stock	stock
floss	floss
wakefulness	wakeful @@ness
numeral	numeral
obey	obey
grimness	grim @@ness
lateen	lateen
nook	nook
hereditarily	hereditary @@ly
liturgically	liturgical @@ly
condom	condom
sudden	sudden
fitness	fit @@ness
egoistical	egoist @@ical
moderation	moderate @@ion
proximately	proximate @@ly
corruptly	corrupt @@ly
relationship	relation @@ship
fleshy	flesh @@y
coir	coir
privilege	privilege
mayoral	mayor @@al
fruity	fruit @@y
bafflingly	baffling @@ly
earthling	earth @@ling
invite	invitation
tilth	till @@th
imprudence	imprudent @@ence
bridge	bridge
coltishly	coltish @@ly
kersey	kersey
snug	snug
sportsman	sport @@s @@man
breathless	breath @@less
rum	rum
tastefully	tasteful @@ly
jaggy	jag @@y
kaleidoscopic	kaleidoscope @@ic
spinach	spinach
fearfully	fearful @@ly
illogically	illogical @@ly
sales	sales
lovingly	loving @@ly
invulnerably	invulnerable @@ly
porosity	porous @@ity
immediateness	immediate @@ness
poker	poke @@er
vengeful	venge @@ful
opportunism	opportune @@ism
vie	vie
goalie	goal @@ie
miff	miff
editorially	editorial @@ly
theirs	their @@s
ghyll	ghyll
frump	frump
bulb	bulb
distrust	dis @@trust
hotfoot	hotfoot
counterclockwise	counterclockwise
city	city
pertinaciously	pertinacious @@ly
dejectedly	dejected @@ly
intentionally	intentional @@ly
brace	brace
predetermine	pre @@determine
explanation	explain @@ation
northwester	northwest @@er
lustre	lustre
woefully	woeful @@ly
vulcanize	Vulcan @@ize
mellowness	mellow @@ness
grumble	grumble
symmetric	symmetry @@ic
madness	mad @@ness
motherly	mother @@ly
chub	chub
mote	mote
roasting	roasting
boisterously	boisterous @@ly
colicky	colic @@y
freakishly	freakish @@ly
lascar	lascar
drove	drove
uncomfortably	uncomfortable @@ly
reel	reel
bill	bill
uncommonly	uncommon @@ly
prediction	predict @@ion
ally	ally
paralytic	paralytic
altruistic	altruist @@ic
cyclically	cyclical @@ly
squabble	squabble
dose	dose
overdose	over @@dose
customary	custom @@ary
whoosh	whoosh
juggle	juggle
expressionism	expression @@ism
feebleminded	feeble @@mind @@ed
tabulator	tabulate @@or
plaintiff	plaintive
photograph	photograph
chesty	chest @@y
blackly	black @@ly
stubborn	stubborn
mend	mend
aspersion	asperse @@ion
resurgence	resurgent @@ence
shackle	shackle
interlard	inter @@lard
sordidly	sordid @@ly
ravishing	ravishing
lewdness	lewd @@ness
systematically	systematic @@ally
piece	piece
manure	manure
haulier	haul @@ier
algorithmic	algorithm @@ic
arquebus	arquebus
shocking	shocking
slattern	slattern
indwell	in @@dwell
widowed	widow @@ed
exertion	exert @@ion
wall	wall
sensationalist	sensationalism @@ist
alumnus	alumnus
schizophrenically	schizophrenic @@ally
combustion	combust @@ion
balcony	balcony
sultanate	sultan @@ate
gavotte	gavotte
pamphlet	pamphlet
namedropper	namedrop @@er
godlike	god @@like
overstep	over @@step
elfishly	elfish @@ly
romper	romp @@er
polder	polder
rightist	right @@ist
peripatetically	peripatetic @@ally
coster	costermonger
coagulation	coagulate @@ion
telegraphic	telegraph @@ic
miaou	miaou
frothily	frothy @@ly
uptown	uptown
hula	hula
reincarnation	reincarnate @@ion
personation	personate @@ion
copse	copse
disincline	dis @@incline
pryingly	prying @@ly
incomparable	in @@comparable
mollusc	mollusc
aft	aft
whereto	whereto
glancingly	glancing @@ly
crosscountry	crosscountry
inmost	in @@most
chickenhearted	chicken @@heart @@ed
portentously	portentous @@ly
murderer	murder @@er
antipodean	antipodes @@an
capital	capital
husky	husk @@y
crore	crore
provision	provide @@ion
brownie	brown @@ie
monkey	monkey
acceptability	acceptable @@ity
impersonally	impersonal @@ly
industrialize	industrial @@ize
meagre	meagre
shower	shower
rick	rick
diagnostic	diagnosis @@ic
externalize	external @@ize
stars	stars
oblong	oblong
foolish	fool @@ish
contrariwise	contrary @@wise
spotless	spot @@less
imperfection	imperfect @@ion
intent	intent
scorer	score @@er
windcheater	wind @@cheat @@er
thorn	thorn
collaborationist	collaborationist
nutritiously	nutritious @@ly
acreage	acre @@age
democratically	democratic @@ally
brim	brim
myrrh	myrrh
terms	terms
depravation	deprave @@ation
itchy	itch @@y
fable	fable
inch	inch
ginger	ginger
scorching	scorching
achievable	achieve @@able
cloudiness	cloudy @@ness
newsiness	newsy @@ness
creeps	creeps
tawdriness	tawdry @@ness
educationalist	educational @@ist
perverseness	perverse @@ness
hazard	hazard
sword	sword
inherit	inherit
certificate	certify @@ate
primitively	primitive @@ly
misdeed	mis @@deed
scold	scold
deucedly	deuced @@ly
sooty	soot @@y
eraser	erase @@er
palliative	palliative
sensibility	sensible @@ity
rationally	rational @@ly
nose	nose
praiseworthiness	praiseworthy @@ness
money	money
wifelike	wife @@like
dramatist	drama @@ist
reveller	revel @@er
scurrility	scurrilous @@ity
peculiar	peculiar
rebelliousness	rebellious @@ness
inequitably	inequitable @@ly
joylessness	joyless @@ness
inaptly	inapt @@ly
fingerprint	fingerprint
devitalization	devitalize @@ation
chin	chin
fountain	fountain
smoothness	smooth @@ness
remake	re @@make
gasification	gasify @@ation
ribald	ribald
discursively	discursive @@ly
empurpled	em @@purple @@ed
divulgence	divulge @@ence
callow	callow
influential	influence @@ial
efficacity	efficacious @@ity
grievousness	grievous @@ness
dashingly	dashing @@ly
shifty	shift @@y
ambit	ambit
fibber	fib @@er
near	near
stoutly	stout @@ly
gallon	gallon
sixthly	sixth @@ly
unwittingly	unwitting @@ly
uprising	up @@rise @@ing
pharmacologist	pharmacology @@ist
coif	coif
retell	re @@tell
unevenly	un @@even @@ly
shun	shun
domestically	domestic @@ally
jeep	jeep
golly	golliwog @@y
ratter	rat @@er
ape	ape
succumb	succumb
trend	trend
collie	collie
clamorously	clamorous @@ly
rubbery	rubber @@y
quarry	quarry
putt	putt
prognosticator	prognosticate @@or
platypus	platypus
happy	hap @@y
instructress	instructor @@ess
middy	midshipman @@y
hereunder	here @@under
nasalize	nasal @@ize
shy	shy
knot	knot
woolliness	woolly @@ness
stork	stork
rubric	rubric
boost	boost
quiescence	quiescent @@ence
interrogation	interrogate @@ion
about	about
rebellion	rebel @@ion
hog	hog
entrant	enter @@ant
personify	person @@ify
chippy	chip @@y
convalescence	convalescent @@ence
gorse	gorse
bisexual	bisexual
willowy	willow @@y
yid	Yiddish
swoon	swoon
asking	asking
poncy	ponce @@y
neglectful	neglect @@ful
testamentary	testament @@ary
restfully	restful @@ly
kola	kola
regions	regions
beau	beau
membrane	membrane
despotically	despotic @@ally
musket	musket
tinselly	tinsel @@y
road	road
subconsciously	subconscious @@ly
inactivity	inactive @@ity
past	past
caucus	caucus
substantiate	substance @@ate
smacker	smack @@er
potholer	pothole @@er
categorical	category @@ical
kismet	kismet
foundation	found @@ation
draught	draught
pied	pie @@ed
cleverly	clever @@ly
unkind	un @@kind
etymologist	etymology @@ist
declamatory	declamation @@ory
bindery	bind @@ery
artistry	artist @@ry
insured	insured
cellar	cellar
bawd	bawd
comfy	comfortable @@y
tine	tine
nameless	name @@less
initiate	initiate
insolence	insolent @@ence
whiskers	whiskers
noninterference	non @@interference
refill	refill
bellyful	belly @@ful
antacid	antacid
hideousness	hideous @@ness
relief	relieve
parsimoniousness	parsimonious @@ness
tiresomely	tiresome @@ly
flitch	flitch
twiggy	twig @@y
aide	aide
federalist	Federalist
knoll	knoll
roomer	room @@er
shutter	shutter
pretentiously	pretentious @@ly
incurably	incurable @@ly
abjuration	abjure @@ation
hedgehopper	hedgehop @@er
scarab	scarab
braggadocio	braggadocio
lidless	lid @@less
pouf	pouf
continuity	continuous @@ity
heal	heal
equator	equate @@or
simulation	simulate @@ion
substantive	substantive
spanner	span @@er
warrantor	warrant @@or
withering	withering
dispensation	dispense @@ation
singular	singular
suitor	suit @@or
cruet	cruet
satrap	satrap
delicacy	delicate @@cy
hag	hag
travelling	travelling
chic	chic
yeast	yeast
tontine	Tonti @@ine
muskiness	musky @@ness
jewelled	jewel @@ed
deprecation	deprecate @@ion
standoffishly	standoffish @@ly
proof	proof
hunch	hunch
anonymous	anonym @@ous
nightmarishly	nightmarish @@ly
wring	wring
laze	laze
tidy	tidy
brisk	brisk
cabaret	cabaret
realistic	realist @@ic
allusive	allusion @@ive
stole	stole
swatter	swat @@er
semaphore	semaphore
cab	cab
lecherousness	lecherous @@ness
agelessness	ageless @@ness
unquestioning	un @@questioning
troth	troth
itch	itch
survey	survey
significative	signification @@ive
corrective	corrective
travesty	travesty
impurity	impure @@ity
undercurrent	under @@current
introductory	introduction @@ory
splodge	splodge
literally	literal @@ly
refrigeration	refrigerate @@ion
threateningly	threatening @@ly
wandering	wandering
strategist	strategy @@ist
inclusive	inclusion @@ive
cruise	cruise
squeeze	squeeze
phaeton	phaeton
fabrication	fabricate @@ion
inestimable	in @@estimable
reach	reach
spastic	spastic
huntress	hunter @@ess
brae	brae
lamprey	lamprey
fumbler	fumble @@er
surrey	surrey
noncontributory	non @@contributory
default	de @@fault
failing	failing
seemingly	seeming @@ly
cliched	cliche @@ed
biltong	biltong
bran	bran
causelessly	causeless @@ly
poised	poised
illusionist	illusion @@ist
involuntarily	involuntary @@ly
inhuman	in @@human
footballer	football @@er
dribble	dribble
slithery	slither @@y
safecracker	safe @@crack @@er
shorts	short @@s
supperless	supper @@less
purport	purport
tobacconist	tobacco @@ist
algebraically	algebraic @@ally
mince	mince
outre	outre
extensiveness	extensive @@ness
liveried	livery @@ed
distress	distress
thrill	thrill
monotonous	monotony @@ous
aphrodisiac	aphrodisiac
sometime	sometime
regretfully	regretful @@ly
strangle	strangle
genie	genie
retort	retort
spurt	spurt
chopper	chop @@er
vibration	vibrate @@ion
commune	commune
marriage	marry @@age
professedly	professed @@ly
predeterminer	pre @@determiner
abilities	abilities
beach	beach
parch	parch
butt	butt
accidental	accident @@al
occupy	occupy
discrepancy	discrepant @@ancy
naval	navy @@al
posturing	posturing
basely	base @@ly
seedsman	seed @@s @@man
inauspicious	in @@auspicious
prink	prink
audition	audit @@ion
perfidious	perfidy @@ous
gunner	gun @@er
muddy	muddy
uppish	up @@ish
callowness	callow @@ness
millionth	millionth
turn	turn
syringe	syringe
solar	solar
hundredth	hundredth
diabolically	diabolical @@ly
nullity	null @@ity
seriatim	seriatim
malarial	malaria @@al
singe	singe
gaggle	gaggle
broadly	broad @@ly
midwifery	midwife @@ery
undertaking	undertaking
confectionery	confection @@ery
salivary	saliva @@ary
ruinous	ruin @@ous
ungainliness	ungainly @@ness
sprite	sprite
gorgeousness	gorgeous @@ness
crotchety	crotchet @@y
habitat	habitat
strumpet	strumpet
surplus	surplus
aeration	aerate @@ion
refulgence	refulgent @@ence
simoon	simoon
occupier	occupy @@er
beaut	beaut
plump	plump
rape	rape
screamingly	scream @@ing @@ly
tumescence	tumescent @@ence
dodderingly	doddering @@ly
indissoluble	in @@dissoluble
dredger	dredge @@er
pettiness	petty @@ness
mope	mope
bifocals	bifocal @@s
mistrust	mis @@trust
androgynous	androgyne @@ous
walker	walk @@er
longish	long @@ish
precipitousness	precipitous @@ness
witticism	witty @@ism
traditionalist	traditionalism @@ist
corny	corn @@y
aitch	aitch
streaky	streak @@y
shop	shop
softy	soft @@y
boots	boots
this	this
psychoanalytical	psychoanalysis @@ical
depressive	depression @@ive
riotousness	riotous @@ness
work	work
overstuffed	over @@stuffed
exiguousness	exiguous @@ness
wreathe	wreath
adroitly	adroit @@ly
years	years
metaphor	metaphor
fitful	fit @@ful
pax	pax
tattle	tattle
subnormal	sub @@normal
amaze	amaze
woollens	woollen @@s
meddlesome	meddle @@some
helm	helm
gulp	gulp
immediacy	immediate @@cy
sectional	section @@al
clandestinely	clandestine @@ly
recompense	recompense
provider	provide @@er
elementarily	elementary @@ly
ruminative	rumination @@ive
patten	patten
journalistically	journalistic @@ally
alcoholism	alcohol @@ism
bulldozer	bulldoze @@er
lip	lip
undated	un @@dated
elfishness	elfish @@ness
enraged	enraged
synchronize	synchronous @@ize
cam	cam
washable	wash @@able
tactful	tact @@ful
outwear	out @@wear
borzoi	borzoi
knowledgeably	knowledgeable @@ly
peelings	peeling @@s
adversely	adverse @@ly
vector	vector
smoocher	smooch @@er
glimmer	glimmer
ceremonial	ceremonial
hang	hang
suggest	suggest
scrag	scrag
lusty	lust @@y
contemptibly	contemptible @@ly
indent	in @@dent
scurry	scurry
prorogation	prorogue @@ation
stagily	stagy @@ly
bar	bar
stonily	stony @@ly
dividers	divide @@er @@s
unrestrained	un @@restrained
lurcher	lurch @@er
serenely	serene @@ly
narcissist	narcissism @@ist
gossip	gossip
chilly	chill @@y
telegraphist	telegraph @@ist
scoff	scoff
immensity	immense @@ity
timeless	time @@less
conic	cone @@ic
mahout	mahout
thankless	thank @@less
nervelessly	nerveless @@ly
wound	wound
incisive	incision @@ive
fowler	fowl @@er
milkiness	milky @@ness
afloat	afloat
cricket	cricket
unhappy	un @@happy
vitamin	vitamin
crowd	crowd
utmost	utmost
tumbrel	tumbrel
unrelentingly	unrelenting @@ly
reiteration	reiterate @@ion
motorize	motor @@ize
gluttony	glutton @@y
attire	attire
goodbye	goodbye
officiousness	officious @@ness
scour	scour
confab	confabulate
purgation	purge @@ation
refraction	refract @@ion
glean	glean
tattiness	tatty @@ness
disloyal	dis @@loyal
adequately	adequate @@ly
polarize	polar @@ize
tod	tod
canine	canine
scalar	scalar
canasta	canasta
hardy	hard @@y
gambling	gambling
warship	war @@ship
consulate	consul @@ate
fertilizer	fertilize @@er
cubical	cube @@ical
ponder	ponder
compression	compress @@ion
overmaster	over @@master
incision	incise @@ion
consistently	consistent @@ly
maize	maize
spoil	spoil
categorize	category @@ize
profligate	profligate
pitiably	pitiable @@ly
secretively	secretive @@ly
rustication	rusticate @@ion
concertedly	concerted @@ly
involved	involved
calf	calf
administration	administer @@ation
boorish	boor @@ish
villa	villa
swimming	swimming
punitive	punish @@ive
homelessness	homeless @@ness
unparalleled	un @@paralleled
lithograph	lithograph
umpire	umpire
raccoon	raccoon
raglan	raglan
dissimilarity	dissimilar @@ity
going	going
process	process
brutalization	brutalize @@ation
degeneracy	degenerate @@cy
invigilation	invigilate @@ion
crazily	crazy @@ly
practice	practise
trail	trail
monogamous	monogamy @@ous
discursiveness	discursive @@ness
appear	appear
chichi	chichi
ground	ground
specialization	specialize @@ation
mugger	mug @@er
buggered	buggered
interrogative	interrogation @@ive
protection	protect @@ion
peevishly	peevish @@ly
defame	de @@fame
protectionism	protection @@ism
residual	residue @@al
thoughtlessly	thoughtless @@ly
kilo	kilo
languorously	languorous @@ly
intolerable	in @@tolerable
subtitle	sub @@title
adaptation	adapt @@ation
marketability	marketable @@ity
institutionalize	institutional @@ize
beget	be @@get
unmistakable	un @@mistakable
lofty	loft @@y
serially	serial @@ly
inarticulateness	inarticulate @@ness
plainly	plain @@ly
investigator	investigate @@or
plutocratic	plutocrat @@ic
ambulant	amble @@ant
congruously	congruous @@ly
shell	shell
constructional	construction @@al
instinctively	instinctive @@ly
inflammation	inflame @@ation
misanthropy	misanthrope @@y
laughing	laughing
disfrock	dis @@frock
separability	separable @@ity
spore	spore
windy	wind @@y
destructive	destruction @@ive
mishit	mishit
blushingly	blushing @@ly
aeronautical	aeronaut @@ical
squib	squib
intentness	intent @@ness
unguarded	un @@guarded
aunt	aunt
barley	barley
uniqueness	unique @@ness
scandalmongering	scandalmonger @@ing
apache	apache
illumination	illuminate @@ion
mighty	mighty
snips	snips
dishearten	dis @@hearten
leggy	leg @@y
shortening	shortening
exhibitionism	exhibition @@ism
principal	principal
lividly	livid @@ly
picket	picket
footle	footle
similarly	similar @@ly
contumelious	contumely @@ous
which	which
electronics	electronic @@s
deletion	delete @@ion
morphemic	morpheme @@ic
detachedly	detached @@ly
hustler	hustle @@er
inexactness	inexact @@ness
quick	quick
late	late
unspeakable	un @@speakable
equivocally	equivocal @@ly
conversationalist	conversational @@ist
operative	operative
latter	latter
deodorant	deodorize @@ant
villain	villain
ton	ton
selection	select @@ion
humanities	humanity @@s
root	root
claw	claw
whin	whin
deceitfulness	deceitful @@ness
acclaim	acclaim
incorporate	in @@corporate
sorter	sort @@er
handiness	handy @@ness
dinginess	dingy @@ness
conjunct	conjunct
thirty	three @@ty
gigantically	gigantic @@ally
rehear	re @@hear
sublimation	sublimate @@ion
manicure	manicure
fosse	fosse
moot	moot
budding	budding
trustfully	trustful @@ly
primitive	primitive
catcall	catcall
bisexuality	bisexual @@ity
succour	succour
bedaub	be @@daub
gradualness	gradual @@ness
wonderingly	wonder @@ing @@ly
wily	wile @@y
sneering	sneering
glad	glad
spume	spume
basil	basil
spikenard	spikenard
jettison	jettison
interact	inter @@act
artiness	arty @@ness
roadworthiness	roadworthy @@ness
paraplegic	paraplegic
salutation	salute @@ation
glare	glare
vibrantly	vibrant @@ly
succubus	succubus
rurally	rural @@ly
verge	verge
dispossessed	dispossessed
straits	straits
runner	run @@er
staging	staging
gloatingly	gloat @@ing @@ly
shocker	shock @@er
incubation	incubate @@ion
telegrapher	telegraph @@er
wobbly	wobble @@y
lump	lump
charivari	charivari
talcum	talcum
dues	dues
greeting	greeting
basketry	basket @@ry
acquisitiveness	acquisitive @@ness
buoyant	buoy @@ant
distantly	distant @@ly
pinnace	pinnace
mass	mass
trivialize	trivial @@ize
humiliation	humiliate @@ion
subtly	subtle @@ly
anthropoid	anthropoid
fold	fold
declension	decline @@ion
betrayer	betray @@er
sighted	sight @@ed
pulchritudinous	pulchritude @@ous
essential	essence @@ial
limit	limit
colloquially	colloquial @@ly
formalist	formalist
howling	howling
spearhead	spearhead
respite	respite
transversely	transverse @@ly
unfurnished	un @@furnished
calm	calm
outsmart	out @@smart
fathomable	fathom @@able
gibbon	gibbon
incomprehension	in @@comprehension
clerihew	clerihew
grab	grab
placed	placed
indestructibility	indestructible @@ity
sexagenarian	sexagenary @@ian
adenoidally	adenoidal @@ly
diadem	diadem
squid	squid
preservative	preservation @@ive
indiscipline	in @@discipline
feel	feel
pitifulness	pitiful @@ness
joviality	jovial @@ity
tailless	tail @@less
stress	stress
scandalous	scandal @@ous
certifiable	certify @@able
arachnid	arachnid
milk	milk
bloke	bloke
son	son
dish	dish
communion	commune @@ion
overbear	over @@bear
swear	swear
loaf	loaf
tarantelle	tarantelle
despoil	de @@spoil
penitently	penitent @@ly
cynically	cynical @@ly
stinger	sting @@er
superstitiously	superstitious @@ly
nerves	nerves
unearthly	un @@earthly
pocket	pocket
submerged	submerged
interchange	inter @@change
lexical	lexicon @@al
commercially	commercial @@ly
lineage	line @@age
sedulously	sedulous @@ly
disassociate	dis @@associate
blasted	blasted
jaw	jaw
necessaries	necessary @@s
beggarliness	beggarly @@ness
lament	lament
bougainvillaea	bougainvillaea
donation	donate @@ion
thinness	thin @@ness
drum	drum
the	the
beloved	beloved
temperately	temperate @@ly
mollification	mollify @@ation
unthinkable	un @@thinkable
sequestered	sequestered
doge	doge
workableness	workable @@ness
indistinctness	indistinct @@ness
misinform	mis @@inform
chill	chill
obsolescence	obsolescent @@ence
weak	weak
cupping	cupping
concomitant	concomitant
weediness	weedy @@ness
piglet	pig @@let
total	total
beastliness	beastly @@ness
aisle	aisle
torpidness	torpid @@ness
midweek	midweek
communicant	communicate @@ant
conscript	conscript
tarnish	tarnish
hearken	hark @@en
revision	revise @@ion
chancellery	chancellor @@ery
makings	making @@s
billsticker	bill @@stick @@er
asthmatic	asthma @@ic
raucously	raucous @@ly
deem	deem
live	live
constrictor	constrict @@or
prebendary	prebend @@ary
floridly	florid @@ly
narcissus	narcissus
ceramics	ceramic @@s
validly	valid @@ly
foolhardiness	foolhardy @@ness
unconvincing	un @@convincing
smooth	smooth
lukewarmly	lukewarm @@ly
impatiently	impatient @@ly
anchoress	anchorite @@ess
tersely	terse @@ly
hysterics	hysteric @@s
fat	fat
enjoyably	enjoyable @@ly
snobbishly	snobbish @@ly
quietness	quiet @@ness
rateability	rateable @@ity
filmable	film @@able
satanically	satanic @@ally
gown	gown
depiction	depict @@ion
minim	minim
effeminately	effeminate @@ly
bull	bull
affluence	affluent @@ence
pyre	pyre
studio	studio
conductivity	conductive @@ity
swot	swot
satirical	satire @@ical
communicably	communicable @@ly
disputable	dispute @@able
agriculturalist	agricultural @@ist
servility	servile @@ity
maverick	maverick
plainswoman	plain @@s @@woman
fictitiously	fictitious @@ly
stanch	stanch
illustrative	illustration @@ive
crossover	cross @@over
coincidental	coincidence @@al
newscaster	newscast @@er
onus	onus
constitutionalize	constitutional @@ize
warble	warble
multitudinousness	multitudinous @@ness
gladness	glad @@ness
backbreakingly	backbreaking @@ly
pylon	pylon
pupa	pupa
duplicator	duplicate @@or
server	serve @@er
lamplighter	lamp @@light @@er
quavery	quaver @@y
bottleful	bottle @@ful
ferociousness	ferocious @@ness
drown	drown
toneless	tone @@less
carcass	carcass
suet	suet
belay	belay
legibility	legible @@ity
bullheadedly	bullheaded @@ly
infection	infect @@ion
equate	equal @@ate
potheen	potheen
limp	limp
dryad	dryad
romanticize	romantic @@ize
namely	name @@ly
internationalization	internationalize @@ation
coke	coke
inhumanity	inhuman @@ity
curdle	curdle
parasitic	parasite @@ic
jumpily	jumpy @@ly
unstudied	un @@studied
jaws	jaws
nonflammable	non @@flammable
substitute	substitute
worthless	worth @@less
gorgeous	gorge @@ous
smallness	small @@ness
sloppily	sloppy @@ly
quintal	quintal
crank	crank
opprobriously	opprobrious @@ly
deadliness	deadly @@ness
cosset	cosset
thread	thread
crabby	crab @@y
blench	blench
crying	crying
steal	steal
snicker	snicker
secondly	second @@ly
jaggedly	jagged @@ly
inconvertible	in @@convertible
coup	coup
veterinarian	veterinary @@an
hatefulness	hateful @@ness
simper	simper
horrific	horrify @@ic
tuft	tuft
psychiatrist	psychiatry @@ist
daub	daub
carefulness	careful @@ness
festoon	festoon
twelfth	twelve @@th
theistic	theist @@ic
toad	toad
degenerate	degenerate
thirstily	thirsty @@ly
satanic	Satan @@ic
crabwise	crab @@wise
spryly	spry @@ly
doc	doctor
waken	wake @@en
checkmate	checkmate
brand	brand
deepen	deep @@en
rhomboidal	rhomboid @@al
factorize	factor @@ize
odds	odd @@s
grape	grape
mason	mason
harper	harp @@er
funniness	funny @@ness
lubricator	lubricate @@or
boldfaced	bold @@face @@ed
unpick	un @@pick
photographic	photograph @@ic
fatefully	fateful @@ly
anopheles	anopheles
alternatively	alternative @@ly
chord	chord
angel	angel
laurels	laurels
eff	eff
riveter	rivet @@er
trump	trump
backwardly	backward @@ly
insure	in @@sure
carburet	carburet
giant	giant
stainless	stain @@less
jerk	jerk
mountaineer	mountaineer
reparations	reparations
anthologized	anthologized
era	era
bounciness	bouncy @@ness
disfigure	dis @@figure
unsullied	un @@sullied
ribaldry	ribald @@ry
bolster	bolster
contest	contest
contraceptive	contraceptive
conditional	conditional
nightmarishness	nightmarish @@ness
scruffy	scruff @@y
soap	soap
arrest	arrest
muslin	muslin
overbid	overbid
phizog	phizog
greasy	grease @@y
oppressiveness	oppressive @@ness
leaseholder	leasehold @@er
finitely	finite @@ly
boomerang	boomerang
valid	valid
focal	focus @@al
heterosexual	heterosexual
goner	gone @@er
vagueness	vague @@ness
idealization	idealize @@ation
herbalist	herbal @@ist
reportage	report @@age
perjurer	perjure @@er
unrelenting	un @@relenting
unbeknownst	unbeknownst
lessee	lease @@ee
cubism	cube @@ism
eulogist	eulogy @@ist
patience	patient @@ence
shavings	shaving @@s
forecast	fore @@cast
liver	live @@er
spareness	spare @@ness
droppings	dropping @@s
choice	choice
ogreishly	ogreish @@ly
praline	praline
outweigh	out @@weigh
potentate	potent @@ate
freebooter	free @@boot @@er
thoroughness	thorough @@ness
speakable	speak @@able
restlessness	restless @@ness
sibylline	sibyl @@ine
misgovern	mis @@govern
sizing	size @@ing
unkindly	unkind @@ly
median	median
key	key
admiringly	admiring @@ly
incongruousness	incongruous @@ness
overall	over @@all
dative	dative
stoned	stoned
foreknow	fore @@know
signaller	signal @@er
rumble	rumble
pastor	pastor
technological	technology @@ical
fives	fives
contumeliously	contumelious @@ly
downheartedly	downhearted @@ly
burden	burden
mill	mill
logging	logging
tropics	tropics
pea	pea
mushy	mush @@y
disorient	dis @@orient
skewer	skewer
coequal	coequal
thinkable	think @@able
destructively	destructive @@ly
introduction	introduce @@ion
exogamous	exogamy @@ous
beech	beech
workable	work @@able
stupidity	stupid @@ity
fruition	fruit @@ion
unbecomingly	unbecoming @@ly
shrine	shrine
lisp	lisp
kinship	kin @@ship
syllogistic	syllogism @@ic
arbitrariness	arbitrary @@ness
earthy	earth @@y
mutely	mute @@ly
box	box
coastguardsman	coastguard @@s @@man
running	running
terminate	terminate
bitingly	biting @@ly
silvery	silver @@y
queerness	queer @@ness
eye	eye
squeamishly	squeamish @@ly
print	print
cornered	cornered
composedly	composed @@ly
indecorously	indecorous @@ly
stretch	stretch
arrack	arrack
monasticism	monastic @@ism
satyric	satyr @@ic
static	state @@ic
palmistry	palmist @@ry
boundary	bound @@ary
synchronization	synchronize @@ation
instate	in @@state
plate	plate
motherliness	motherly @@ness
ringer	ring @@er
regret	regret
sadistically	sadistic @@ally
faithless	faith @@less
shod	shod
measurable	measure @@able
alphabetical	alphabet @@ical
nurture	nurture
deliberation	deliberate @@ion
squirt	squirt
positional	position @@al
poisonously	poisonous @@ly
wretchedly	wretched @@ly
flute	flute
anything	anything
deliberate	deliberate
flightiness	flighty @@ness
conversational	conversation @@al
villainies	villainy @@s
revisionist	revisionism @@ist
fashionable	fashion @@able
applaud	applaud
superciliousness	supercilious @@ness
untenable	un @@tenable
qualification	qualify @@ation
opportunely	opportune @@ly
glider	glide @@er
acceptation	accept @@ation
congestion	congest @@ion
enrol	en @@roll
encounter	encounter
lea	lea
scene	scene
methanol	methanol
chirpy	chirp @@y
alert	alert
desegregate	de @@segregate
impulse	impulse
insertion	insert @@ion
creative	creation @@ive
praetorian	praetor @@ian
passionate	passion @@ate
mammal	mammal
modernism	modern @@ism
ponderable	ponder @@able
fourthly	fourth @@ly
reformatory	reformation @@ory
wrench	wrench
pain	pain
accrue	accrue
nope	nope
conception	conceive @@ion
preponderantly	preponderant @@ly
rondo	rondo
fifty	five @@ty
quietly	quiet @@ly
proposer	propose @@er
grasping	grasping
fiddling	fiddling
sinkable	sink @@able
harmlessly	harmless @@ly
clamour	clamour
extension	extend @@ion
introverted	introvert @@ed
pollen	pollen
smudge	smudge
epicurean	epicure @@an
gored	gore @@ed
submergence	submerge @@ence
concert	concert
squealer	squeal @@er
mad	mad
copulative	copulative
probate	probate
choosy	choose @@y
misadvise	mis @@advise
including	including
intermission	intermit @@ion
adorable	adore @@able
axle	axle
evaporate	e @@vapour @@ate
jugful	jug @@ful
helplessly	helpless @@ly
earthen	earth @@en
snipe	snipe
girlie	girl @@ie
bream	bream
glossy	gloss @@y
theatre	theatre
embarrassingly	embarrassing @@ly
modesty	modest @@y
usurer	usury @@er
quest	quest
extroversion	extrovert @@ion
dare	dare
rouble	rouble
ten	ten
psychiatrically	psychiatric @@ally
unalterably	un @@alterable @@ly
obscenely	obscene @@ly
following	following
fluoridize	fluoride @@ize
kirsch	kirsch
tastily	tasty @@ly
correlative	correlative
dispossess	dis @@possess
paring	paring
overly	over @@ly
leftist	leftist
despairingly	despairing @@ly
agglomeration	agglomerate @@ion
recovery	recover @@ery
idylic	idyll @@ic
darts	darts
pureness	pure @@ness
takings	taking @@s
venom	venom
intended	intended
cinch	cinch
ritualistically	ritualistic @@ally
sextette	sextette
perfectionist	perfection @@ist
gutturally	guttural @@ly
clinical	clinic @@al
perspicaciously	perspicacious @@ly
patchily	patchy @@ly
altruist	altruism @@ist
willingness	willing @@ness
barebacked	bareback @@ed
tenderness	tender @@ness
professorially	professorial @@ly
roost	roost
annunciation	announce @@ation
pacesetter	pace @@set @@er
maddening	maddening
nick	nick
leveller	level @@er
underlie	under @@lie
enormous	enormity @@ous
inaptness	inapt @@ness
funk	funk
alien	alien
sans	sans
scourge	scourge
flapper	flap @@er
unclaimed	un @@claimed
downstairs	downstairs
faithlessly	faithless @@ly
nought	nought
murderous	murder @@ous
observatory	observation @@ory
toffee	toffee
thoughtlessness	thoughtless @@ness
midway	midway
leakiness	leaky @@ness
absently	absent @@ly
fuller	full @@er
deceiver	deceive @@er
designate	designate
rake	rake
seethe	seethe
penetratively	penetrative @@ly
electrician	electricity @@ian
dacoity	dacoit @@y
diabetic	diabetes @@ic
crumbly	crumble @@y
scaffold	scaffold
testis	testis
account	account
chevron	chevron
inscription	inscribe @@ion
fitfully	fitful @@ly
ossification	ossify @@ation
carnally	carnal @@ly
starry	star @@y
separate	separate
payable	pay @@able
unsex	un @@sex
epic	epic
rebelliously	rebellious @@ly
narration	narrate @@ion
tolerantly	tolerant @@ly
nett	nett
vociferousness	vociferous @@ness
sneer	sneer
roughshod	roughshod
rueful	rue @@ful
circulation	circulate @@ion
perspicuously	perspicuous @@ly
subjectivity	subjective @@ity
popadum	popadum
metronome	metronome
flatten	flat @@en
tradesman	trade @@s @@man
thieve	thief
bracelets	bracelets
arresting	arresting
dauntless	daunt @@less
childishness	childish @@ness
sheer	sheer
operatic	opera @@ic
reft	bereft
generator	generate @@or
uneventfulness	uneventful @@ness
undock	un @@dock
hop	hop
thereunder	there @@under
progesterone	progesterone
neatly	neat @@ly
paunch	paunch
starkly	stark @@ly
cos	cos
cancel	cancel
beneficially	beneficial @@ly
hose	hose
marge	marge
stylist	style @@ist
stinginess	stingy @@ness
rhymed	rhymed
indecently	indecent @@ly
perniciousness	pernicious @@ness
rioter	riot @@er
legendary	legend @@ary
caressingly	caressing @@ly
crap	crap
frigidity	frigid @@ity
insecure	in @@secure
technically	technical @@ly
playfulness	playful @@ness
quarterly	quarterly
dominoes	dominoes
infirmity	infirm @@ity
incidence	incident @@ence
declaration	declare @@ation
reprovingly	reproving @@ly
readiness	ready @@ness
fratricidal	fratricide @@al
collected	collected
liable	liable
speciously	specious @@ly
pleasantness	pleasant @@ness
forward	forward
lunge	lunge
lastly	last @@ly
unionist	union @@ist
come	come
proud	proud
retrial	re @@trial
peculiarity	peculiar @@ity
festal	feast @@al
solicitor	solicit @@or
nescience	nescient @@ence
scantiness	scanty @@ness
scramble	scramble
incredibly	incredible @@ly
fiat	fiat
firmly	firm @@ly
said	said
incredible	in @@credible
unattached	un @@attached
trial	try @@al
unlawfully	unlawful @@ly
infertility	infertile @@ity
striated	striated
scrappy	scrap @@y
completely	complete @@ly
belt	belt
princess	prince @@ess
fifth	fifth
temptingly	tempting @@ly
emphatic	emphasis @@ic
attributive	attribute @@ive
encipher	en @@cipher
thievish	thief @@ish
informality	informal @@ity
miserliness	miserly @@ness
hanky	handkerchief @@y
wallop	wallop
underarm	under @@arm
snail	snail
curling	curling
jubilation	jubilate @@ion
locker	lock @@er
effects	effects
cohesion	cohere @@ion
pleach	pleach
eligibly	eligible @@ly
amoebic	amoeba @@ic
peremptorily	peremptory @@ly
voyeuristically	voyeuristic @@ally
soulfulness	soulful @@ness
organ	organ
more	more
rallentando	rallentando
presents	present @@s
cerise	cerise
thick	thick
location	locate @@ion
hieroglyphics	hieroglyphic @@s
refreshments	refreshments
socialization	socialize @@ation
halo	halo
eagerly	eager @@ly
feast	feast
viciousness	vicious @@ness
tube	tube
caviller	cavil @@er
casting	casting
thesaurus	thesaurus
plaice	plaice
fatherhood	father @@hood
wordiness	wordy @@ness
happen	happen
astride	astride
infirmary	infirm @@ary
quartering	quartering
springlike	spring @@like
slouching	slouching
detour	de @@tour
musketry	musket @@ry
astigmatic	astigmatism @@ic
teem	teem
supra	supra
wonted	wont @@ed
plight	plight
delightfully	delightful @@ly
beatifically	beatific @@ally
rally	rally
checker	check @@er
fours	fours
orphan	orphan
trust	trust
dash	dash
predominant	predominate @@ant
mantilla	mantilla
believably	believable @@ly
declarable	declare @@able
avowal	avow @@al
stomp	stomp
philistinism	philistine @@ism
patty	patty
immorality	immoral @@ity
preach	preach
malmsey	malmsey
asp	asp
unfortunate	unfortunate
sequel	sequel
tincture	tincture
eviscerate	e @@viscera @@ate
isolationist	isolationism @@ist
lineal	line @@al
shew	shew
sprawl	sprawl
fantastical	fantasy @@ical
disused	disuse @@ed
gullibly	gullible @@ly
amaryllis	amaryllis
brown	brown
flier	fly @@er
churlishness	churlish @@ness
muckraker	muckrake @@er
outlaw	out @@law
overwhelmingly	overwhelming @@ly
tidily	tidy @@ly
symbol	symbol
lakh	lakh
age	age
anna	anna
striking	striking
advantageous	advantage @@ous
theosophist	theosophy @@ist
orientalist	oriental @@ist
dowse	dowse
terminably	terminable @@ly
burnous	burnous
trope	trope
floral	flora @@al
tracked	track @@ed
straight	straight
crisscross	crisscross
evidence	evident @@ence
variableness	variable @@ness
unequalness	unequal @@ness
unalienable	un @@alienable
guilefully	guileful @@ly
delouse	de @@louse
meaningfulness	meaningful @@ness
lustiness	lusty @@ness
mattress	mattress
compactly	compact @@ly
pastrami	pastrami
redo	re @@do
squander	squander
reservation	reserve @@ation
scintillate	scintillate
puniness	puny @@ness
admirably	admirable @@ly
dishorn	dis @@horn
spice	spice
substratum	sub @@stratum
pontificals	pontifical @@s
beam	beam
trachoma	trachoma
philanthropically	philanthropic @@ally
costumier	costume @@ier
venomed	venom @@ed
olden	old @@en
frightening	frightening
etiolation	etiolate @@ion
sweep	sweep
elucidatory	elucidation @@ory
separable	separate @@able
complementary	complement @@ary
convoy	convoy
rodeo	rodeo
gratuitous	gratuity @@ous
gondolier	gondola @@ier
curio	curio
jaundiced	jaundiced
tidiness	tidy @@ness
jaundice	jaundice
impishness	impish @@ness
dazedly	daze @@ed @@ly
impromptu	impromptu
porker	pork @@er
narcotic	narcotic
seneschal	seneschal
ancient	ancient
planking	planking
chiffon	chiffon
surrealist	surrealism @@ist
perm	perm
unhealthy	un @@healthy
expenses	expenses
japan	japan
dumpiness	dumpy @@ness
slacken	slack @@en
zoological	zoology @@ical
misdemean	mis @@demean
creole	creole
military	military
sea	sea
telegraphy	telegraph @@y
philosophic	philosophy @@ic
lamp	lamp
shoal	shoal
inconspicuously	inconspicuous @@ly
locomotive	locomotive
decarbonize	de @@carbonize
scribble	scribble
vixenish	vixen @@ish
lewdly	lewd @@ly
wand	wand
cajole	cajole
apparel	apparel
groundlessly	groundless @@ly
possessively	possessive @@ly
acidulous	acidulate @@ous
playlet	play @@let
overt	overt
housing	housing
holloa	holloa
disaffect	dis @@affect
fend	fend
bloody	blood @@y
smilax	smilax
glorification	glorify @@ation
unfriendly	un @@friendly
recuperative	recuperation @@ive
fate	fate
paving	paving
dumper	dump @@er
unaccustomed	un @@accustomed
then	then
dowsing	dowsing
seasonal	season @@al
dynamically	dynamic @@ally
climb	climb
politics	politic @@s
squall	squall
wife	wife
direct	direct
unloose	un @@loose
pulpy	pulp @@y
detective	detection @@ive
sifter	sift @@er
squash	squash
squelch	squelch
maxim	maxim
bodily	body @@ly
anemone	anemone
enticingly	enticing @@ly
inimitably	inimitable @@ly
pauperize	pauper @@ize
outwards	outward @@s
expediently	expedient @@ly
assorted	assorted
headachy	headache @@y
honesty	honest @@y
hollow	hollow
canton	canton
befall	be @@fall
tractability	tractable @@ity
mover	move @@er
reproachfully	reproachful @@ly
pard	pardner
wooden	wood @@en
sluggish	slug @@ish
mourner	mourn @@er
shade	shade
tired	tired
exclamation	exclaim @@ation
morass	morass
lamely	lame @@ly
unclean	un @@clean
catsup	catsup
genealogical	genealogy @@ical
boastfully	boastful @@ly
interminably	interminable @@ly
ambitious	ambition @@ous
apprehensively	apprehensive @@ly
wanderings	wandering @@s
hypochondriac	hypochondriac
institutional	institution @@al
construe	construe
drift	drift
witlessly	witless @@ly
dominantly	dominant @@ly
boding	boding
involuntary	in @@voluntary
foreknowledge	fore @@knowledge
information	inform @@ation
forgetfulness	forgetful @@ness
piebald	piebald
disadvantageous	disadvantage @@ous
saintlike	saint @@like
bug	bug
amusing	amusing
bisexually	bisexual @@ly
ticklish	tickle @@ish
thievishly	thievish @@ly
urinate	urine @@ate
obviously	obvious @@ly
democratize	democrat @@ize
east	east
satiric	satire @@ic
spavin	spavin
squiggle	squiggle
create	create
priestess	priest @@ess
incestuous	incest @@ous
hearty	heart @@y
distributively	distributive @@ly
misbehaved	misbehaved
seraphic	seraph @@ic
pipes	bagpipes
shorten	short @@en
coco	coco
heroine	hero @@ine
opinionated	opinion @@ate @@ed
powder	powder
morphological	morphology @@ical
muzzily	muzzy @@ly
spider	spider
doltish	dolt @@ish
bothersome	bother @@some
herculean	Hercules @@an
essential	essential
vaingloriously	vainglorious @@ly
closely	close @@ly
nor	nor
oak	oak
talkie	talk @@ie
deformed	deformed
rhetorical	rhetoric @@al
cellist	cello @@ist
childhood	child @@hood
comfortless	comfort @@less
solace	solace
hostel	hostel
virginity	virgin @@ity
unbridled	un @@bridled
economically	economic @@ally
entrench	en @@trench
ream	ream
rote	rote
tearlessly	tearless @@ly
keeper	keep @@er
shoe	shoe
staff	staff
retailer	retail @@er
fleece	fleece
inmate	in @@mate
orderly	order @@ly
variously	various @@ly
retouch	re @@touch
dovetail	dovetail
crescendo	crescendo
canyon	canyon
prosaic	prose @@ic
asthmatically	asthmatic @@ally
bushed	bush @@ed
deviant	deviant
hospitalize	hospital @@ize
angler	angle @@er
swamp	swamp
patella	patella
hastiness	hasty @@ness
opulently	opulent @@ly
fibrous	fibre @@ous
foremost	foremost
seedily	seedy @@ly
womanhood	woman @@hood
merit	merit
pastel	pastel
topgallant	topgallant
bilingual	bilingual
ably	able @@ly
prematurely	premature @@ly
peg	peg
journalism	journal @@ism
motive	motive
tightness	tight @@ness
cautiously	cautious @@ly
cataract	cataract
incurable	in @@curable
epidemic	epidemic
calomel	calomel
activate	active @@ate
moaner	moan @@er
bedding	bed @@ing
capillarity	capillary @@ity
hyphenate	hyphen @@ate
plagiarize	plagiarism @@ize
junta	junta
boot	boot
tributary	tributary
desensitization	desensitize @@ation
shopper	shop @@er
rustic	rustic
peril	peril
outcrop	out @@crop
immodestly	immodest @@ly
adamant	adamant
plastering	plaster @@ing
inquirer	inquire @@er
sprout	sprout
eighteen	eighteen
discredit	discredit
awfully	awful @@ly
pelisse	pelisse
mick	mick
prefab	prefabrication
dismember	dis @@member
hermaphroditic	hermaphrodite @@ic
contraindicated	contraindicated
harp	harp
scoundrelly	scoundrel @@y
repot	re @@pot
vex	vex
accuser	accuse @@er
zenith	zenith
vegetarianism	vegetarian @@ism
trainee	train @@ee
provisionally	provisional @@ly
sceneshifter	scenery @@shift @@er
slaughterer	slaughter @@er
boastful	boast @@ful
mordantly	mordant @@ly
mammy	mam @@y
speak	speak
tolerable	tolerate @@able
incrementally	incremental @@ly
bane	bane
irregularly	irregular @@ly
underclothing	under @@clothing
mist	mist
trustworthiness	trustworthy @@ness
projectionist	projection @@ist
unskilled	un @@skilled
sabre	sabre
vote	vote
lusciously	luscious @@ly
concuss	concuss
panelling	panelling
satin	satin
throughout	through @@out
infinity	infinite @@y
typically	typical @@ly
chasuble	chasuble
manioc	manioc
prickliness	prickly @@ness
curatorship	curator @@ship
directly	directly
infectious	infection @@ous
zippy	zip @@y
smell	smell
racist	racism @@ist
would	would
charming	charming
irrigable	irrigate @@able
plating	plating
filbert	filbert
everlastingly	everlasting @@ly
spam	spam
kinetics	kinetic @@s
surprisingly	surprising @@ly
beautiful	beauty @@ful
indecisively	indecisive @@ly
strategic	strategy @@ic
reproductive	re @@productive
snicker	snick @@er
levant	levant
freewheel	free @@wheel
questioningly	questioning @@ly
stun	stun
fain	fain
religious	religious
discompose	dis @@compose
dejected	dejected
divot	divot
uncompromisingly	uncompromising @@ly
sheldrake	sheldrake
judiciously	judicious @@ly
mornings	morning @@s
surmise	surmise
worker	work @@er
puffed	puffed
prime	prime
relay	re @@lay
citation	cite @@ation
ontologically	ontological @@ly
ode	ode
projectile	projectile
pantingly	pant @@ing @@ly
walrus	walrus
codification	codify @@ation
misspell	mis @@spell
discreetly	discreet @@ly
offence	offend @@ence
lemon	lemon
landau	landau
eighth	eight @@th
supportable	support @@able
reinsure	re @@insure
clan	clan
wigwam	wigwam
ceremonially	ceremonial @@ly
insulation	insulate @@ion
dislike	dislike
tardily	tardy @@ly
tessellated	tessellated
jocularly	jocular @@ly
fortifiable	fortify @@able
ballast	ballast
embroidery	embroider @@ery
lechery	lecher @@ery
tedious	tedium @@ous
consubstantiation	consubstantiate @@ion
treacherously	treacherous @@ly
feebleness	feeble @@ness
fool	fool
ineradicable	in @@eradicable
moodily	moody @@ly
poulterer	poultry @@er
primness	prim @@ness
disrobe	dis @@robe
rob	rob
liveliness	lively @@ness
owlish	owl @@ish
cordial	cordial
poetry	poet @@ry
shag	shag
precociously	precocious @@ly
marble	marble
energetically	energetic @@ally
timothy	timothy
away	away
prohibitory	prohibition @@ory
crusade	crusade
nationalistically	nationalistic @@ally
blather	blather
reputably	reputable @@ly
cease	cease
rhythmically	rhythmical @@ly
abbot	abbot
usher	usher
cussedly	cussed @@ly
virgin	virgin
pardner	pardner
profitlessly	profitless @@ly
pebbly	pebble @@y
vinyl	vinyl
principal	principle @@al
flattery	flatter @@ery
resentfully	resentful @@ly
fennel	fennel
dear	dear
disabuse	dis @@abuse
sluggishness	sluggish @@ness
joggle	joggle
edict	edict
compulsion	compel @@ion
healer	heal @@er
disdainful	disdain @@ful
torturer	torture @@er
pule	pule
comically	comic @@ally
usurp	usurp
meteorite	meteor @@ite
fondant	fondant
pudendum	pudendum
cage	cage
dispassionately	dispassionate @@ly
slowness	slow @@ness
loath	loath
heir	heir
bugger	bugger
prosodic	prosody @@ic
complacently	complacent @@ly
disprove	dis @@prove
league	league
decimalization	decimalize @@ation
inaccuracy	inaccurate @@cy
archetypical	archetype @@ical
librarianship	librarian @@ship
township	town @@ship
faithfully	faithful @@ly
overmantel	over @@mantel
inoffensive	in @@offensive
personage	person @@age
henna	henna
influentially	influential @@ly
heretically	heretical @@ly
tannin	tannin
determinative	determination @@ive
fiesta	fiesta
ibid	ibid
fluently	fluent @@ly
heterosexually	heterosexual @@ly
concatenation	concatenate @@ion
hibernation	hibernate @@ion
fishing	fishing
addict	addict
revoltingly	revolting @@ly
biscuit	biscuit
impassive	im @@passion @@ive
softly	soft @@ly
listenable	listen @@able
chukka	chukka
pacifically	pacific @@ally
mongol	mongol
gland	gland
leprous	leper @@ous
freely	free @@ly
shilling	shilling
dolorous	dolour @@ous
invalidation	invalidate @@ion
oddly	odd @@ly
earliness	early @@ness
perhaps	per @@hap @@s
spindly	spindle @@y
stick	stick
greed	greed
incompressible	in @@compressible
conciliation	conciliate @@ion
compensatory	compensation @@ory
redistribution	redistribute @@ion
clerical	cleric @@al
burial	bury @@al
tinkle	tinkle
pilot	pilot
kinky	kink @@y
humanity	human @@ity
fraternally	fraternal @@ly
quickness	quick @@ness
tempestuousness	tempestuous @@ness
evaporation	evaporate @@ion
sib	sib
coverlet	cover @@let
directive	direction @@ive
vacantly	vacant @@ly
cumulatively	cumulative @@ly
dryer	dry @@er
stupor	stupor
vintage	vintage
disconnected	disconnected
rationalize	rational @@ize
melodic	melody @@ic
sound	sound
repute	repute
nuttiness	nutty @@ness
pregnancy	pregnant @@ancy
serial	serial
adaptability	adaptable @@ity
reversibility	reversible @@ity
gloat	gloat
luxuriantly	luxuriant @@ly
masterful	master @@ful
unwarranted	un @@warranted
sticker	stick @@er
drivel	drivel
pomp	pomp
vandal	vandal
menially	menial @@ly
disagreeable	disagree @@able
promiscuously	promiscuous @@ly
intelligence	intelligent @@ence
outstrip	out @@strip
affirmation	affirm @@ation
toast	toast
advances	advances
abettor	abet @@or
knobbly	knob @@ly
sonorously	sonorous @@ly
ink	ink
increasingly	increase @@ing @@ly
efface	efface
hymn	hymn
merciful	mercy @@ful
niggardliness	niggardly @@ness
vertebra	vertebra
should	should
goof	goof
apoplectic	apoplexy @@ic
psychiatric	psychiatry @@ic
authoritarian	authoritarian
cravenness	craven @@ness
rubbish	rubbish
indecipherability	indecipherable @@ity
idolatrous	idolatry @@ous
sage	sage
carelessly	careless @@ly
impracticably	impracticable @@ly
proofreader	proofread @@er
incongruously	incongruous @@ly
ellipse	ellipse
generously	generous @@ly
wintery	winter @@y
whenever	whenever
stamen	stamen
outmatch	out @@match
hue	hue
outwork	out @@work
worriedly	worried @@ly
readability	readable @@ity
engrossingly	engrossing @@ly
peony	peony
embarrassing	embarrassing
dactylic	dactyl @@ic
stinker	stink @@er
crispy	crisp @@y
theorem	theorem
translation	translate @@ion
unfaltering	un @@faltering
forebode	fore @@bode
sect	sect
sleepiness	sleepy @@ness
damp	damp
installation	install @@ation
bait	bait
rancorously	rancorous @@ly
suffering	suffering
rustless	rust @@less
imbecile	imbecile
devastation	devastate @@ion
consumer	consume @@er
suitableness	suitable @@ness
leeringly	leering @@ly
concordant	concord @@ant
hoarsely	hoarse @@ly
irateness	irate @@ness
gibbet	gibbet
spidery	spider @@y
sickish	sick @@ish
jewellery	jewel @@ery
precincts	precincts
cockle	cockle
fortunate	fortune @@ate
gruellingly	gruelling @@ly
matchlessly	matchless @@ly
answerably	answerable @@ly
ethos	ethos
emotion	emote @@ion
alike	a @@like
raspingly	rasping @@ly
supplanter	supplant @@er
timbre	timbre
experiment	experiment
curl	curl
backhanded	backhanded
frames	frames
inhibitedly	inhibited @@ly
brisket	brisket
pendulously	pendulous @@ly
cot	cot
shortsighted	short @@sight @@ed
judge	judge
correctness	correct @@ness
ulterior	ulterior
swallower	swallow @@er
highly	high @@ly
randiness	randy @@ness
zigzag	zigzag
malcontent	malcontent
tarpaulin	tarpaulin
tanning	tanning
canvas	canvas
retake	re @@take
examiner	examine @@er
mouldy	mould @@y
colon	colon
workmanlike	workman @@like
bypass	bypass
common	common
nimbleness	nimble @@ness
downright	downright
discretion	discrete @@ion
barring	barring
asphalt	asphalt
protectively	protective @@ly
saturation	saturate @@ion
fructification	fructify @@ation
suspension	suspend @@ion
lightship	light @@ship
saxophonist	saxophone @@ist
conference	confer @@ence
rejoicing	rejoicing
chauvinist	chauvinist
jailer	jail @@er
bearded	beard @@ed
bestrew	be @@strew
marbles	marbles
inorganic	in @@organic
ignite	ignite
misappropriate	mis @@appropriate
tenderly	tender @@ly
quackery	quack @@ery
gayness	gay @@ness
incapacitate	incapacity @@ate
popularly	popular @@ly
cleverness	clever @@ness
remorselessly	remorseless @@ly
professor	profess @@or
hybridize	hybrid @@ize
angelically	angelical @@ly
originality	original @@ity
accommodations	accommodations
literalness	literal @@ness
baggy	bag @@y
vastness	vast @@ness
next	next
erotica	erotica
type	type
respectfully	respectful @@ly
insubstantial	in @@substantial
sparse	sparse
piousness	pious @@ness
faultily	faulty @@ly
ever	ever
centre	centre
carve	carve
placidity	placid @@ity
gavel	gavel
incapability	incapable @@ity
victoria	Victoria
fossilization	fossilize @@ation
newsy	news @@y
indeterminable	in @@determinable
tit	tit
misgive	mis @@give
moisturize	moisture @@ize
advanced	advanced
eponymous	eponym @@ous
dishful	dish @@ful
tickle	tickle
serviette	serviette
rubberize	rubber @@ize
content	content
supposing	supposing
lance	lance
camper	camp @@er
extremity	extreme @@ity
fastening	fastening
cholerically	choleric @@ally
motionlessly	motionless @@ly
wrestle	wrestle
guru	guru
unquestioned	un @@questioned
ramble	ramble
politicalize	political @@ize
tartly	tart @@ly
journalistic	journalist @@ic
bumptiousness	bumptious @@ness
argot	argot
trippingly	tripping @@ly
proton	proton
submissiveness	submissive @@ness
grounding	grounding
overtone	over @@tone
prosaically	prosaic @@ally
ganger	gang @@er
speleological	speleology @@ical
efficaciously	efficacious @@ly
resourcefulness	resourceful @@ness
bogus	bogus
maritally	marital @@ly
precision	precise @@ion
maggoty	maggot @@y
inflatable	inflate @@able
culturally	cultural @@ly
parboil	parboil
insultingly	insulting @@ly
heterodoxy	heterodox @@y
intelligibly	intelligible @@ly
germ	germ
dismounted	dismounted
wrinkly	wrinkle @@y
seepage	seep @@age
weather	weather
laboriousness	laborious @@ness
slips	slips
skating	skating
rendering	rendering
effusion	effuse @@ion
appellant	appellant
pleasurably	pleasurable @@ly
swinger	swing @@er
ploy	ploy
politically	political @@ly
nullify	null @@ify
galloping	galloping
marten	marten
stuffiness	stuffy @@ness
pulpit	pulpit
formation	form @@ation
latitudinarian	latitudinarian
brawny	brawn @@y
forgiveness	forgive @@ness
sultrily	sultry @@ly
cap	cap
bland	bland
scolding	scolding
feminist	feminism @@ist
pituitary	pituitary
ambassadress	ambassador @@ess
grating	grating
simile	simile
entertaining	entertaining
musty	must @@y
prodigality	prodigal @@ity
spar	spar
finalist	final @@ist
dull	dull
corral	corral
dunce	dunce
insalubrious	in @@salubrious
risibility	risible @@ity
eventually	eventual @@ly
tactics	tactics
flavour	flavour
riffraff	riffraff
smuggle	smuggle
dispenser	dispense @@er
mysteriously	mysterious @@ly
paint	paint
creek	creek
entail	entail
tubby	tub @@y
mam	mam
clinically	clinical @@ly
louvred	louvre @@ed
waxy	wax @@y
interchangeably	interchangeable @@ly
stark	stark
locality	local @@ity
creakily	creaky @@ly
catalpa	catalpa
bloomers	bloomer @@s
stimulation	stimulate @@ion
her	her
visitor	visit @@or
pauperization	pauperize @@ation
perspiration	perspire @@ation
repentant	repentant
cryptically	cryptic @@ally
chipmunk	chipmunk
hypnotize	hypnotism @@ize
adventurer	adventure @@er
bey	bey
fit	fit
dethrone	de @@throne
cloister	cloister
centralize	central @@ize
bag	bag
masonic	masonic
coign	coign
sled	sled
predicatively	predicative @@ly
cornice	cornice
scree	scree
unearth	un @@earth
shuffler	shuffle @@er
encompass	en @@compass
broil	broil
churchgoer	church @@go @@er
backwardness	backward @@ness
provincial	provincial
vigil	vigil
beta	beta
prattle	prattle
operationally	operational @@ly
beguiling	beguiling
amplification	amplify @@ation
complex	complex
why	why
stays	stays
tungsten	tungsten
uncork	un @@cork
poisoner	poison @@er
controversial	controversy @@al
lawn	lawn
whereupon	whereupon
amorality	amoral @@ity
uncharted	un @@charted
flimsily	flimsy @@ly
utmost	out @@most
fluffy	fluff @@y
end	end
hard	hard
middling	middle @@ing
masturbatory	masturbation @@ory
instantaneousness	instantaneous @@ness
ism	ism
verruca	verruca
elliptically	elliptical @@ly
complainer	complain @@er
wobble	wobble
jawbreaker	jaw @@break @@er
misadventure	mis @@adventure
mine	mine
hockey	hockey
therapeutical	therapy @@ical
scaly	scale @@y
impertinence	impertinent @@ence
bayonet	bayonet
forehead	fore @@head
gaucho	gaucho
cauterize	cautery @@ize
conveyancer	conveyance @@er
foursome	four @@some
suction	suck @@ion
counteraction	counteract @@ion
agitated	agitated
unprejudiced	un @@prejudiced
brittle	brittle
incursion	incur @@ion
homesickness	homesick @@ness
rhinoceros	rhinoceros
preliterate	pre @@literate
forefinger	fore @@finger
dross	dross
roof	roof
revitalize	re @@vitalize
delicately	delicate @@ly
multiple	multiple
clutches	clutches
mood	mood
insensate	in @@sense @@ate
moil	moil
woad	woad
clarty	clarts @@y
coldly	cold @@ly
trendiness	trendy @@ness
foot	foot
overmuch	overmuch
exceptionable	exception @@able
shale	shale
seamer	seam @@er
unaccountably	unaccountable @@ly
supplicant	supplicate @@ant
quagga	quagga
stubby	stub @@y
candidly	candid @@ly
seconds	second @@s
divisively	divisive @@ly
italic	italic
clean	clean
conversationally	conversational @@ly
breather	breathe @@er
equipped	equipped
hoydenish	hoyden @@ish
cable	cable
entranced	entranced
prophetically	prophetic @@ally
carnival	carnival
mammoth	mammoth
skateboarder	skateboard @@er
precedence	precedent @@ence
kebab	kebab
officiously	officious @@ly
peeler	peel @@er
slighting	slighting
declaim	de @@claim
shipbuilder	ship @@builder
malignancy	malignant @@ancy
deceptively	deceptive @@ly
helper	help @@er
oratory	oration @@ory
complicated	complicated
questioner	question @@er
dig	dig
calypso	calypso
need	need
tranquillity	tranquil @@ity
incandescently	incandescent @@ly
lovelorn	lovelorn
remover	remove @@er
corporately	corporate @@ly
sparks	sparks
sip	sip
conceivably	conceivable @@ly
chancy	chance @@y
thermoplastic	thermoplastic
tritely	trite @@ly
extract	extract
normal	normal
solely	sole @@ly
crone	crone
mound	mound
qualifications	qualifications
rejection	reject @@ion
bastinado	bastinado
forced	forced
befit	be @@fit
fearless	fear @@less
specs	spectacles
cashmere	cashmere
tranny	transistor @@y
vaccinate	vaccine @@ate
fin	fin
overseer	oversee @@er
buoyancy	buoyant @@ancy
miserably	miserable @@ly
agonized	agonized
fierce	fierce
tomboyish	tomboy @@ish
source	source
feudatory	feudatory
stodginess	stodgy @@ness
tuner	tune @@er
swerve	swerve
thievishness	thievish @@ness
inlay	in @@lay
beery	beer @@y
laudatory	laud @@ory
pontificate	pontiff @@ate
armful	arm @@ful
dewiness	dewy @@ness
consumptive	consumption @@ive
incompetently	incompetent @@ly
teller	tell @@er
ball	ball
knitting	knitting
materially	material @@ly
note	note
realize	real @@ize
looks	looks
ravings	raving @@s
contrary	contrary
preachify	preach @@ify
recollection	recollect @@ion
coat	coat
are	are
calculus	calculus
litterateur	litterateur
injurious	injury @@ous
strolling	strolling
glimmerings	glimmering @@s
hurricane	hurricane
jasmine	jasmine
girlish	girl @@ish
richness	rich @@ness
episcopalian	episcopalian
desecration	desecrate @@ion
invigilator	invigilate @@or
site	site
chantry	chant @@ry
lynx	lynx
telephotography	telephotograph @@y
undeniably	undeniable @@ly
equably	equable @@ly
unbelievable	un @@believable
rhythmic	rhythm @@ic
pert	pert
indicator	indicate @@or
beggarly	beggar @@ly
rift	rift
corrosive	corrosive
saliva	saliva
melodiously	melodious @@ly
plumpness	plump @@ness
caster	cast @@er
displeasing	displeasing
hear	hear
personalty	personal @@ty
heedfulness	heedful @@ness
roue	roue
asphyxiate	asphyxia @@ate
pitifully	pitiful @@ly
system	system
leap	leap
incarnate	incarnate
sporty	sport @@y
furlough	furlough
sadistic	sadist @@ic
topographical	topography @@ical
chaff	chaff
commonage	common @@age
penitential	penitence @@ial
eighty	eight @@ty
zing	zing
cerebrate	cerebrum @@ate
wetly	wet @@ly
jockey	jockey
shrinkage	shrink @@age
panties	pants @@y @@s
expo	exposition
halibut	halibut
graduation	graduate @@ion
canonical	canon @@ical
fair	fair
birth	bear @@th
regulator	regulate @@or
trauma	trauma
substantival	substantive @@al
foreordain	fore @@ordain
phlox	phlox
dueller	duel @@er
ingrown	in @@grown
shapely	shape @@ly
peregrination	peregrinate @@ion
underneath	under @@beneath
rimless	rim @@less
anon	anon
efflorescence	efflorescent @@ence
predestination	predestine @@ation
extremely	extreme @@ly
terrific	terrify @@ic
surefooted	sure @@foot @@ed
shamefully	shameful @@ly
inertness	inert @@ness
grid	grid
expeditious	expedition @@ous
antibiotic	antibiotic
stetson	stetson
handsome	hand @@some
accentuate	accent @@ate
anus	anus
lawless	law @@less
screwy	screw @@y
thrush	thrush
pup	pup
diddle	diddle
overlong	overlong
trashy	trash @@y
agate	agate
prophetess	prophet @@ess
babel	babel
captivity	captive @@ity
yardage	yard @@age
beggar	beggar
heartiness	hearty @@ness
beauteously	beauteous @@ly
pound	pound
horrors	horrors
trachea	trachea
frankfurter	Frankfurt @@er
upset	upset
accusing	accusing
radioactivity	radioactive @@ity
number	number
ravel	ravel
primer	prime @@er
speeding	speeding
monarchical	monarch @@ical
his	his
shake	shake
disaffiliate	dis @@affiliate
whaling	whaling
flesh	flesh
nearly	near @@ly
terminally	terminal @@ly
provably	provable @@ly
pompously	pompous @@ly
foolishness	foolish @@ness
effusiveness	effusive @@ness
waspish	wasp @@ish
nonviolently	nonviolent @@ly
traditionalism	traditional @@ism
reflexive	reflexive
sophisticate	sophisticate
distinctive	distinction @@ive
presage	presage
musicianship	musician @@ship
laughingly	laughing @@ly
unknowing	un @@knowing
inadmissibly	inadmissible @@ly
nut	nut
lard	lard
rub	rub
stubble	stubble
conga	conga
slenderness	slender @@ness
radiantly	radiant @@ly
benumbed	be @@numb @@ed
divergently	divergent @@ly
meretriciousness	meretricious @@ness
complaining	complaining
topping	topping
gad	gad
devitalize	de @@vitalize
penuriously	penurious @@ly
lesser	lesser
housebreaker	house @@break @@er
angelical	angel @@ical
homey	home @@y
detestably	detestable @@ly
rubber	rubber
savoury	savour @@y
toppingly	topping @@ly
slightingly	slighting @@ly
obstructiveness	obstructive @@ness
showery	shower @@y
recriminatory	recrimination @@ory
platonically	platonic @@ally
driveller	drivel @@er
incomprehensibility	incomprehensible @@ity
chastity	chaste @@ity
shallowness	shallow @@ness
splice	splice
four	four
meaningfully	meaningful @@ly
bannock	bannock
righteousness	righteous @@ness
morsel	morsel
balance	balance
monitor	monitor
demonstrative	demonstration @@ive
yacht	yacht
prepossessing	prepossessing
grave	grave
cargo	cargo
yachtsman	yacht @@s @@man
supernova	super @@nova
presence	present @@ence
advisability	advisable @@ity
robust	robust
peacefully	peaceful @@ly
genetically	genetic @@ally
tremble	tremble
nonpareil	nonpareil
inspectorate	inspector @@ate
practised	practised
masochistic	masochist @@ic
gudgeon	gudgeon
impassiveness	impassive @@ness
rig	rig
crackling	crackling
tufted	tuft @@ed
yearning	yearning
elements	elements
gnaw	gnaw
hobnob	hobnob
contagiously	contagious @@ly
fibre	fibre
jingo	jingo
inadequacy	inadequate @@cy
formally	formal @@ly
centavo	centavo
prurience	prurient @@ence
priming	priming
naturalism	natural @@ism
purdah	purdah
visually	visual @@ly
disagreeableness	disagreeable @@ness
pasty	pasty
overweeningly	overweening @@ly
dissoluble	dis @@soluble
exhibitionist	exhibitionism @@ist
elector	elect @@or
pivot	pivot
nonconformism	non @@conform @@ism
disproportionately	disproportionate @@ly
scoffer	scoff @@er
triumphant	triumph @@ant
fortuitously	fortuitous @@ly
carry	carry
terpsichorean	terpsichorean
preserve	preserve
nutritive	nutrition @@ive
trenchantly	trenchant @@ly
canalization	canalize @@ation
insurmountable	in @@surmountable
ordain	ordain
partial	part @@ial
hoary	hoar @@y
covertly	covert @@ly
idle	idle
discipline	discipline
imposing	imposing
flatness	flat @@ness
wadding	wadding
attitudinize	attitude @@ize
many	many
description	describe @@ion
parry	parry
pug	pug
muckle	muckle
generality	general @@ity
conceivable	conceive @@able
steadiness	steady @@ness
slimming	slimming
tuberculous	tubercle @@ous
uniquely	unique @@ly
sympathizingly	sympathizing @@ly
raid	raid
bedeck	be @@deck
reproach	reproach
voluptuously	voluptuous @@ly
generally	general @@ly
mutuality	mutual @@ity
sanctities	sanctities
memento	memento
costliness	costly @@ness
bohemian	bohemian
eastward	eastward
parlance	parlance
mutability	mutable @@ity
statehood	state @@hood
sneeze	sneeze
showing	showing
expatriate	expatriate
massage	massage
desalinize	de @@saline @@ize
jog	jog
possessed	possessed
literately	literate @@ly
brewery	brew @@ery
armada	armada
jester	jest @@er
innumerable	in @@numerable
casserole	casserole
cicada	cicada
campaigner	campaign @@er
pragmatically	pragmatic @@ally
metaphysical	metaphysics @@al
digs	digs
overdraft	over @@draft
throughout	throughout
attempt	attempt
hypo	hypo
adhesive	adhesive
jobless	job @@less
existential	existence @@ial
staggers	staggers
rapacity	rapacious @@ity
nosy	nose @@y
foresight	fore @@sight
ghetto	ghetto
pamper	pamper
truss	truss
dismally	dismal @@ly
ribbon	ribbon
plosive	plosive
allegorically	allegorical @@ly
beholder	behold @@er
anglicize	anglicism @@ize
shiftlessness	shiftless @@ness
