diasuransikan	di @@asuransi @@kan
resminya	resmi @@nya
kurs	kurs
solidaritas	solidaritas
karakteristiknya	karakteristik @@nya
mengijinkan	men @@ijin @@kan
beroperasinya	ber @@operasi @@nya
menjualnya	men @@jual @@nya
mobilitas	mobilitas
getah	getah
pesanannya	pesan @@an @@nya
laba	laba
pernafasan	per @@nafas @@an
membebankan	men @@beban @@kan
dipelajarinya	di @@pelajar @@i @@nya
masukan	masuk @@an
sayap	sayap
sesuainya	sesuai @@nya
gemilang	gemilang
mengeringkan	men @@kering @@kan
mereproduksinya	men @@reproduksi @@nya
menggema	men @@gema
terselubung	ter @@selubung
bertukar	ber @@tukar
kawal	kawal
terluka	ter @@luka
sistem	sistem
petanya	peta @@nya
riilnya	riil @@nya
angkutan	angkut @@an
hayatnya	hayat @@nya
rinci	rinci
miliki	milik @@i
simbol	simbol
acuan	acu @@an
brutonya	bruto @@nya
investigasinya	investigasi @@nya
terpecahkan	ter @@pecah @@kan
lebat	lebat
membelokkan	men @@belok @@kan
meneguhkan	men @@teguh @@kan
butuh	butuh
mempekerjakannya	men @@pekerja @@kan @@nya
akad	akad
ajarkan	ajar @@kan
adikku	adik @@ku
mengiklankan	men @@iklan @@kan
balas	balas
memastikan	men @@pasti @@kan
pasangannya	pasang @@an @@nya
pengrusakan	pen @@rusak @@an
berpotensial	ber @@potensial
reaktif	reaktif
kebungkaman	ke @@bungkam @@an
pematang	pen @@matang
renangnya	renang @@nya
jaya	jaya
memimpikan	men @@mimpi @@kan
makam	makam
menyelenggarakan	men @@selenggara @@kan
farmasi	farmasi
supir	supir
diplomatik	diplomatik
saksikan	saksi @@kan
menyangkal	men @@sangkal
serendah	se @@rendah
menyepakatinya	men @@sepakat @@i @@nya
residual	residual
jejak	jejak
berambisi	ber @@ambisi
memantapkan	men @@mantap @@kan
angkut	angkut
pancuran	pancur @@an
diperbudak	di @@per @@budak
penyetoran	pen @@setor @@an
dipandang	di @@pandang
persaudaraannya	per @@saudara @@an @@nya
perbantahan	per @@bantah @@an
dicanangkan	di @@canang @@kan
ketidaksiapan	ke @@tidak @@siap @@an
dipermuliakan	di @@per @@mulia @@kan
taksir	taksir
melintasi	men @@lintas @@i
menyusunnya	men @@susun @@nya
ditetapkan	di @@tetap @@kan
bergabung	ber @@gabung
alas	alas
mengabarkan	men @@kabar @@kan
hampa	hampa
bernama	ber @@nama
nuansa	nuansa
menoleransinya	men @@toleransi @@nya
diadakannya	di @@ada @@kan @@nya
keeratan	ke @@erat @@an
dibahas	di @@bahas
tembusan	tembus @@an
patah	patah
ampas	ampas
menyederhanakan	men @@sederhana @@kan
pencipta	pen @@cipta
menguatkan	men @@kuat @@kan
diumumkan	di @@umum @@kan
talentanya	talenta @@nya
perhiasan	per @@hias @@an
wartawan	wartawan
pengangkatan	pen @@angkat @@an
mendominasinya	men @@dominasi @@nya
keikutsertaan	ke @@ikutserta @@an
merespon	men @@respon
pelukan	peluk @@an
keliling	keliling
lokasi	lokasi
berbenah	ber @@benah
rona	rona
impian	impian
kepunyaan	ke @@punya @@an
bergantung	ber @@gantung
petisi	petisi
diulang	di @@ulang
mengurus	men @@urus
bersenjata	ber @@senjata
pepohonan	pepohonan
identitas	identitas
tembak	tembak
kerangka	kerangka
sepak	sepak
ishak	ishak
bersaksi	ber @@saksi
pemasarannya	pen @@pasar @@an @@nya
menstimulasi	men @@stimulasi
gaji	gaji
keturunannya	ke @@turun @@an @@nya
berkarya	ber @@karya
kontroversial	kontroversial
mengedit	men @@edit
pekerja	pekerja
sejauh	se @@jauh
kasihi	kasih @@i
senin	senin
dikatakan	di @@kata @@kan
digalakkan	di @@galak @@kan
seekor	se @@ekor
layar	layar
omongnya	omong @@nya
pengingat	pen @@ingat
ayahmu	ayah @@mu
pengacau	pen @@kacau
rekonstruksinya	rekonstruksi @@nya
terlewatnya	ter @@lewat @@nya
diamanatkan	di @@amanat @@kan
pergelangan	per @@gelang @@an
api	api
pizza	pizza
defisit	defisit
musuhmu	musuh @@mu
menjagaku	men @@jaga @@aku
gol	gol
terkutuk	ter @@kutuk
pertaruhan	per @@taruh @@an
diikutinya	di @@ikut @@i @@nya
monitor	monitor
meminati	men @@minat @@i
menginterpretasikan	men @@interpretasi @@kan
perijinan	per @@ijin @@an
inisiatifnya	inisiatif @@nya
aktivis	aktivis
kualifikasinya	kualifikasi @@nya
dimanfaatkan	di @@manfaat @@kan
sehari	se @@hari
mendiktekan	men @@dikte @@kan
carinya	cari @@nya
dihina	di @@hina
kuncinya	kunci @@nya
allahmu	allah @@mu
santunku	santun @@ku
konkrit	konkrit
lahir	lahir
kristal	kristal
jemaatnya	jemaat @@nya
divonis	di @@vonis
teratas	ter @@atas
sekeras	se @@keras
meminjam	men @@pinjam
dimandatkan	di @@mandat @@kan
kala	kala
perwira	perwira
bernapas	ber @@napas
modul	modul
sebaiknya	se @@baik @@nya
pengabdian	pen @@abdi @@an
seksi	seks @@i
potensialnya	potensial @@nya
pertimbangannya	per @@timbang @@an @@nya
bertekuk	ber @@tekuk
terhilang	ter @@hilang
perhotelan	per @@hotel @@an
natal	natal
menyucikan	men @@suci @@kan
mencurinya	men @@curi @@nya
berkata	ber @@kata
diceraikan	di @@cerai @@kan
memilikinya	men @@milik @@i @@nya
melambaikan	men @@lambai @@kan
daratannya	darat @@an @@nya
serahkan	serah @@kan
kuatkan	kuat @@kan
imunisasi	imunisasi
mendetail	men @@detail
dokumennya	dokumen @@nya
diperintahkan	di @@perintah @@kan
krim	krim
irigasi	irigasi
mendermakan	men @@derma @@kan
alat	alat
mendaftar	men @@daftar
timnya	tim @@nya
penguasanya	pen @@kuasa @@nya
klorofil	klorofil
keju	keju
mencicil	men @@cicil
sobekan	sobek @@an
berkorelasi	ber @@korelasi
hasilnya	hasil @@nya
mengkoordinasikannya	men @@koordinasi @@kan @@nya
terusik	ter @@usik
pergiliran	per @@gilir @@an
memukulnya	men @@pukul @@nya
hidrogen	hidrogen
berbicara	ber @@bicara
menunjuknya	men @@tunjuk @@nya
pendataan	pen @@data @@an
diaplikasikan	di @@aplikasi @@kan
doktrin	doktrin
bahagiaku	bahagia @@aku
karib	karib
berpikiran	ber @@pikir @@an
didatangi	di @@datang @@i
tenis	tenis
mengeluh	men @@keluh
bahkan	bah @@kan
perpisahan	per @@pisah @@an
penampungan	pen @@tampung @@an
rendah	rendah
membuahkan	men @@buah @@kan
menabrak	men @@tabrak
tertabrak	ter @@tabrak
melunasinya	men @@lunas @@i @@nya
barangnya	barang @@nya
bertolak	ber @@tolak
melipat	men @@lipat
tanggapan	tanggap @@an
sekawasan	se @@kawasan
berkilau	ber @@kilau
disebar	di @@sebar
praktisnya	praktis @@nya
penampilannya	pen @@tampil @@an @@nya
dikoreksi	di @@koreksi
pertimbangan	per @@timbang @@an
berorganisasi	ber @@organisasi
karier	karier
membalikkannya	men @@balik @@kan @@nya
pembalasan	pen @@balas @@an
wakili	wakil @@i
disebabkan	di @@sebab @@kan
persalinan	per @@salin @@an
penyisihan	pen @@sisih @@an
sepengetahuan	se @@pengetahuan
merubuhkan	men @@rubuh @@kan
dipilih	di @@pilih
memanjatkan	men @@panjat @@kan
perkataanmu	per @@kata @@an @@mu
maut	maut
kuponnya	kupon @@nya
berderit	ber @@derit
berkebangsaan	ber @@ke @@bangsa @@an
usaha	usaha
obatan	obat @@an
terganggunya	ter @@ganggu @@nya
mengaktifkan	men @@aktif @@kan
curiga	curiga
menghafalkan	men @@hafal @@kan
khususnya	khusus @@nya
pemainnya	pen @@main @@nya
disuntik	di @@suntik
ikan	ikan
desain	desain
berbaris	ber @@baris
belokan	belok @@an
menggenangi	men @@genang @@i
akademik	akademik
mematahkan	men @@patah @@kan
pendorong	pen @@dorong
alot	alot
menghubunginya	men @@hubung @@i @@nya
otoriter	otoriter
stempel	stempel
segan	segan
menyingkap	men @@singkap
perahunya	perahu @@nya
dilabuhkan	di @@labuh @@kan
pilihan	pilih @@an
antar	antar
tebangan	tebang @@an
lusinan	lusin @@an
sekrup	sekrup
kawan	kawan
bawahmu	bawah @@mu
berbunga	ber @@bunga
kemas	kemas
prinsipnya	prinsip @@nya
diemban	di @@emban
sesampainya	se @@sampai @@nya
terselenggaranya	ter @@selenggara @@nya
rekomendasi	rekomendasi
membaik	men @@baik
persaingannya	per @@saing @@an @@nya
diwawancarai	di @@wawancara @@i
ditegaskan	di @@tegas @@kan
menghapuskan	men @@hapus @@kan
mendalami	men @@dalam @@i
berbuntut	ber @@buntut
perlengkapan	per @@lengkap @@an
dicukur	di @@cukur
dinasnya	dinas @@nya
datang	datang
menyamar	men @@samar
membelenggu	men @@belenggu
internalnya	internal @@nya
merajalela	men @@rajalela
durian	duri @@an
tersungkur	ter @@sungkur
belahan	belah @@an
dimarahi	di @@marah @@i
pendahulunya	pendahulu @@nya
penyidikan	pen @@sidik @@an
mendidik	men @@didik
pencobaan	pen @@coba @@an
selesaikan	selesai @@kan
mendirikan	men @@diri @@kan
tabungan	tabung @@an
mengganti	men @@ganti
mengartikannya	men @@arti @@kan @@nya
dikelilingi	di @@keliling @@i
pembelian	pen @@beli @@an
menyetorkannya	men @@setor @@kan @@nya
teknik	teknik
negosiasi	negosiasi
statis	statis
menumpas	men @@tumpas
gilir	gilir
perkasa	perkasa
fitur	fitur
kehendakku	kehendak @@ku
terkecil	ter @@kecil
hektare	hektare
menyengsarakan	men @@sengsara @@kan
diskriminasi	diskriminasi
menangani	men @@tangan @@i
memperolehnya	men @@peroleh @@nya
denyut	denyut
terbangun	ter @@bangun
otomatis	otomatis
memberitahukan	men @@beritahu @@kan
mengoreksi	men @@koreksi
penarikan	pen @@tarik @@an
ditulis	di @@tulis
mencercanya	men @@cerca @@nya
datangnya	datang @@nya
mengasihiku	men @@kasih @@i @@ku
subur	subur
peneguhan	pen @@teguh @@an
pencetus	pen @@cetus
diperbarui	di @@per @@baru @@i
kesenjangan	kesenjangan
bergerak	ber @@gerak
mengancam	men @@ancam
iseng	iseng
memetakan	men @@peta @@kan
dilaksanakan	di @@laksana @@kan
sisanya	sisa @@nya
semenarik	se @@menarik
sukacitaku	sukacita @@aku
ubi	ubi
mual	mual
diungkap	di @@ungkap
didiskusikan	di @@diskusi @@kan
bekal	bekal
menyambutku	men @@sambut @@ku
tahunnya	tahun @@nya
distorsi	distorsi
terjebak	ter @@jebak
menjelekkan	men @@jelek @@kan
dicairkan	di @@cair @@kan
perilaku	perilaku
konsorsium	konsorsium
rekaman	rekam @@an
informan	informan
kurikulum	kurikulum
merealokasi	men @@realokasi
iringan	iring @@an
tulangku	tulang @@ku
tepukan	tepuk @@an
menentukan	men @@tentu @@kan
tercipta	ter @@cipta
disaksikan	di @@saksi @@kan
menjerat	men @@jerat
seterusnya	se @@terus @@nya
nyata	nyata
diikutsertakannya	di @@ikutserta @@kan @@nya
mengikutinya	men @@ikut @@i @@nya
diselamatkannya	di @@selamat @@kan @@nya
menjamurnya	men @@jamur @@nya
membatu	men @@batu
memprediksikan	men @@prediksi @@kan
beregenerasi	ber @@regenerasi
deputi	deputi
kolaborasi	kolaborasi
dibayangkan	di @@bayang @@kan
inspirasi	inspirasi
bicaranya	bicara @@nya
delegasi	delegasi
beranggota	ber @@anggota
adat	adat
mengkonsumsi	men @@konsumsi
dibebankan	di @@beban @@kan
diterlantarkan	di @@terlantar @@kan
administratifnya	administratif @@nya
dikoordinasi	di @@koordinasi
penuturan	pen @@tutur @@an
menerbitkan	men @@terbit @@kan
dipersempit	di @@per @@sempit
sebanyak	se @@banyak
hapuskan	hapus @@kan
mencintaiku	men @@cinta @@i @@ku
mahasiswanya	mahasiswa @@nya
traktor	traktor
peti	peti
campak	campak
penggoda	pen @@goda
pemdanya	pemda @@nya
inisial	inisial
harapannya	harap @@an @@nya
terpelihara	ter @@pelihara
memucat	men @@pucat
perkelahian	per @@kelahi @@an
sumberdaya	sumberdaya
pas	pas
bloknya	blok @@nya
gerbang	gerbang
dimungkinkan	dimungkinkan
kuatirmu	kuatir @@mu
menghancurkannya	men @@hancur @@kan @@nya
digendong	di @@gendong
nonfisik	non @@fisik
peneliti	pen @@teliti
dijelaskan	di @@jelas @@kan
penanggulangannya	pen @@tanggulang @@an @@nya
rw	rw
meramaikan	men @@ramai @@kan
ajaibnya	ajaib @@nya
diinspirasikan	di @@inspirasi @@kan
didekati	di @@dekat @@i
ketidakcocokan	ke @@tidak @@cocok @@an
toko	toko
diindonesiakan	di @@indonesia @@kan
efisiensinya	efisiensi @@nya
membelanjakannya	men @@belanja @@kan @@nya
disoroti	di @@sorot @@i
bergurau	ber @@gurau
memperkecil	men @@kecil
mengutus	men @@utus
pembacanya	pen @@baca @@nya
mengikut	men @@ikut
separah	se @@parah
perkataan	per @@kata @@an
panitia	panitia
membidangi	men @@bidang @@i
pembayarannya	pen @@bayar @@an @@nya
dimuntahkan	di @@muntah @@kan
dioperasikan	di @@operasi @@kan
pembangunan	pen @@bangun @@an
primer	primer
lembaran	lembar @@an
arif	arif
domisili	domisili
hilang	hilang
pembuatnya	pen @@buat @@nya
disaat	di @@saat
berkabungnya	berkabung @@nya
terlempar	ter @@lempar
lelaki	lelaki
termuda	ter @@muda
sebanding	se @@banding
dijabat	di @@jabat
tunggu	tunggu
truk	truk
rambutan	rambut @@an
menantangnya	men @@tantang @@nya
aplikasi	aplikasi
mandiri	mandiri
pembatalan	pen @@batal @@an
kedengaran	ke @@dengar @@an
menyanggupi	men @@sanggup @@i
arteri	arteri
identitasnya	identitas @@nya
dipilihkan	di @@pilih @@kan
komponen	komponen
proteksi	proteksi
berprofesi	ber @@profesi
pastikan	pasti @@kan
percekcokan	per @@cekcok @@an
tuanku	tuan @@ku
perwakilan	per @@wakil @@an
firmanku	firman @@ku
renungan	renung @@an
menumbuhkannya	men @@tumbuh @@kan @@nya
tips	tips
terpola	ter @@pola
pria	pria
liter	liter
tercanggih	ter @@canggih
kaisar	kaisar
kitab	kitab
melelehkan	men @@leleh @@kan
retribusi	retribusi
pengadministrasian	pen @@administrasi @@an
bersandar	ber @@sandar
kasi	kas @@i
terlupakan	ter @@lupa @@kan
kurungan	kurung @@an
parameter	parameter
digarap	di @@garap
mengidap	men @@idap
mengunjunginya	men @@kunjung @@i @@nya
terlontar	ter @@lontar
ditanggung	di @@tanggung
mencantumkan	men @@cantum @@kan
pertempuran	per @@tempur @@an
seimbang	seimbang
berlabuh	ber @@labuh
diizinkan	di @@izin @@kan
sangka	sangka
rambutmu	rambut @@mu
menandingi	men @@tanding @@i
meyakinkan	men @@yakin @@kan
informasinya	informasi @@nya
disebarluaskan	di @@sebarluas @@kan
melampirkan	men @@lampir @@kan
terbayar	ter @@bayar
membaiknya	men @@baik @@nya
independent	independent
kuat	kuat
terdahsyat	ter @@dahsyat
mempunyai	men @@punya @@i
ditekel	di @@tekel
antarpengukuran	antar @@pen @@ukur @@an
roboh	roboh
mempelajarinya	men @@pelajar @@i @@nya
mengintervensi	men @@intervensi
naik	naik
menuntaskan	men @@tuntas @@kan
kelapanya	kelapa @@nya
mengantarkan	men @@antar @@kan
memaksa	men @@paksa
menampung	men @@tampung
bajakannya	bajak @@an @@nya
alfabet	alfabet
tembok	tembok
berkompromi	ber @@kompromi
melaksanakan	men @@laksana @@kan
menyanggah	men @@sanggah
sederhanakan	sederhana @@kan
antarmitra	antar @@mitra
deklarasi	deklarasi
jembatannya	jembatan @@nya
terberatnya	ter @@berat @@nya
diciumnya	di @@cium @@nya
ditentukan	di @@tentu @@kan
hancurnya	hancur @@nya
eksklusif	eksklusif
penyalur	pen @@salur
ala	ala
didiagnosis	di @@diagnosis
memberitahu	men @@beritahu
dibangunkan	di @@bangun @@kan
penggantinya	pen @@ganti @@nya
mengevaluasi	men @@evaluasi
taruhan	taruh @@an
mewakilinya	men @@wakil @@i @@nya
berkeberatan	ber @@ke @@berat @@an
terdefinisi	ter @@definisi
baru	baru
diketahui	di @@ketahui
disimpulkannya	di @@simpul @@kan @@nya
terawat	ter @@rawat
peminjaman	pen @@pinjam @@an
menyuapkannya	men @@suap @@kan @@nya
salad	salad
sinarnya	sinar @@nya
telpon	telpon
kronis	kronis
pengulangan	pen @@ulang @@an
mengikutsertakan	men @@ikutserta @@kan
khawatirkan	khawatir @@kan
dirangkum	di @@rangkum
semusim	se @@musim
diikat	di @@ikat
penanya	pen @@tanya
bait	bait
membiayainya	men @@biaya @@i @@nya
merujuk	men @@rujuk
ekor	ekor
teduh	teduh
terpopuler	ter @@populer
semak	semak
patriotik	patriotik
ditelaah	di @@telaah
bagian	bagi @@an
bayaran	bayar @@an
lensa	lensa
mengkoordinasi	men @@koordinasi
kondisi	kondisi
figurnya	figur @@nya
pencacahan	pen @@cacah @@an
ibukota	ibukota
terheran	ter @@heran
elektronik	elektronik
intervensi	intervensi
keriput	keriput
pembagi	pen @@bagi
dibicarakan	di @@bicara @@kan
tergolong	ter @@golong
modal	modal
berakibat	ber @@akibat
pasangan	pasang @@an
dampak	dampak
pengenal	pen @@kenal
eceran	ecer @@an
nun	nun
jinak	jinak
peralatan	per @@alat @@an
adik	adik
kuota	kuota
melawan	men @@lawan
gulungan	gulung @@an
dikuatkan	di @@kuat @@kan
bersaat	ber @@saat
protes	protes
masuk	masuk
diantar	di @@antar
berkorban	ber @@korban
disimpulkan	di @@simpul @@kan
ikut	ikut
perundingan	pen @@runding @@an
penuntut	pen @@tuntut
memanah	men @@panah
diperkenalkannya	di @@per @@kenal @@kan @@nya
mikro	mikro
gratis	gratis
bersikap	ber @@sikap
gigitan	gigit @@an
institusi	institusi
diformulasikan	di @@formulasi @@kan
resolusi	resolusi
dihanguskan	di @@hangus @@kan
saluran	salur @@an
jauhnya	jauh @@nya
terbilang	ter @@bilang
memprosesnya	men @@proses @@nya
lanjut	lanjut
perawat	pen @@rawat
memungkinkannya	memungkinkan @@nya
pemusnahan	pen @@musnah @@an
antusiasmenya	antusiasme @@nya
mengutuk	men @@kutuk
dibimbing	di @@bimbing
termulia	ter @@mulia
sampingan	samping @@an
mengandalkan	men @@andal @@kan
minumnya	minum @@nya
bermusuhan	ber @@musuh @@an
himbauan	himbau @@an
bertanya	ber @@tanya
perkaretan	per @@karet @@an
penyebarluasan	pen @@sebarluas @@an
bersekolah	ber @@sekolah
tenteram	tenteram
mengaduk	men @@aduk
penganyam	pen @@anyam
mengisahkan	men @@kisah @@kan
ditempel	di @@tempel
persalinannya	per @@salin @@an @@nya
radikal	radikal
tersingkirnya	ter @@singkir @@nya
netral	netral
juruselamatku	juruselamat @@ku
diramalkan	di @@ramal @@kan
merdeka	merdeka
tutup	tutup
senjatanya	senjata @@nya
konkret	konkret
naturnya	natur @@nya
perduli	perduli
tergenang	ter @@genang
tampak	tampak
minat	minat
bangsawan	bangsa @@wan
disiram	di @@siram
dimakamkan	di @@makam @@kan
mempersiapkannya	men @@siap @@kan @@nya
mendatangkan	men @@datang @@kan
beranggapan	ber @@anggap @@an
tuntutannya	tuntut @@an @@nya
diteladankan	di @@teladan @@kan
realis	realis
prancis	prancis
tersihir	ter @@sihir
paradigma	paradigma
dianalisis	di @@analisis
inggris	inggris
kemajuan	ke @@maju @@an
wilayah	wilayah
sahabatku	sahabat @@ku
mengemuka	men @@kemuka
nafsunya	nafsu @@nya
tabung	tabung
berlatar	ber @@latar
diintegrasikan	di @@integrasi @@kan
respons	respons
suaminya	suami @@nya
berpegang	ber @@pegang
mengimplementasikan	men @@implementasi @@kan
nutrisinya	nutrisi @@nya
terhormat	ter @@hormat
petik	petik
legitimasi	legitimasi
bergulingan	ber @@guling @@an
pencuci	pen @@cuci
pekan	pekan
sesamamu	se @@sama @@mu
food	food
berbadan	ber @@badan
ketidakaktifan	ke @@tidak @@aktif @@an
tonggak	tonggak
diharuskan	di @@harus @@kan
disebutkan	di @@sebut @@kan
terlindung	ter @@lindung
basi	bas @@i
pembantuan	pen @@bantu @@an
yatim	yatim
mengadopsi	men @@adopsi
kamu	kamu
tempat	tempat
pengaudit	pen @@audit
lutut	lutut
akbar	akbar
pengasingan	pen @@asing @@an
beragam	ber @@ragam
dihitung	di @@hitung
mengguncangkan	men @@guncang @@kan
bayi	bayi
menggoncangkan	men @@goncang @@kan
amoral	amoral
saudara	saudara
instrumen	instrumen
ukurannya	ukur @@an @@nya
mengontrak	men @@kontrak
keterlibatan	ke @@terlibat @@an
penyuluhan	pen @@suluh @@an
mandatnya	mandat @@nya
menengok	men @@tengok
berkeadilan	ber @@ke @@adil @@an
manajerial	manajerial
mencobanya	men @@coba @@nya
meluncurkan	men @@luncur @@kan
diperankan	di @@peran @@kan
berpindah	ber @@pindah
jam	jam
kencang	kencang
menghapusnya	men @@hapus @@nya
cucunya	cucu @@nya
memaksanya	men @@paksa @@nya
menjembatani	men @@jembatan @@i
mendapat	men @@dapat
distribusi	distribusi
tertundanya	ter @@tunda @@nya
bernegosiasi	ber @@negosiasi
meneruskan	men @@terus @@kan
dimaksudkannya	di @@maksud @@kan @@nya
merombak	men @@rombak
ketidakefektifan	ke @@tidak @@efektif @@an
memantau	men @@pantau
domestik	domestik
mahkamah	mahkamah
kenangan	kenang @@an
lumpur	lumpur
empuk	empuk
takut	takut
berdialog	ber @@dialog
sepanjang	se @@panjang
melemparkan	men @@lempar @@kan
berimbas	ber @@imbas
berargumentasi	ber @@argumentasi
jelasnya	jelas @@nya
kredibel	kredibel
pembajakan	pen @@bajak @@an
sekotak	se @@kotak
antarsektor	antar @@sektor
didera	di @@dera
terdistribusi	ter @@distribusi
bepergian	bepergian
terkoordinir	ter @@koordinir
mendebarkan	men @@debar @@kan
memasyarakat	men @@masyarakat
angsurannya	angsur @@an @@nya
lengan	lengan
bahasan	bahas @@an
konfrontasi	konfrontasi
misalnya	misal @@nya
stasiun	stasiun
kompromi	kompromi
sebarannya	sebar @@an @@nya
pendapat	pen @@dapat
triwulan	triwulan
dosen	dosen
terprogram	ter @@program
dibekali	di @@bekal @@i
berusaha	ber @@usaha
membiayai	men @@biaya @@i
firaun	firaun
merenggut	men @@renggut
mencekik	men @@cekik
antarjenjang	antar @@jenjang
dijerumuskan	di @@jerumus @@kan
dipenuhi	di @@penuh @@i
dikurung	di @@kurung
terdahulu	terdahulu
faktanya	fakta @@nya
mil	mil
antarprogram	antar @@program
laporannya	lapor @@an @@nya
peta	peta
ofensif	ofensif
sampannya	sampan @@nya
pemberitaan	pen @@berita @@an
hatimu	hati @@mu
mengurusi	men @@urus @@i
dideklarasikan	di @@deklarasi @@kan
alokasinya	alokasi @@nya
astronom	astronom
dimobilisasi	di @@mobilisasi
perceraian	per @@cerai @@an
persiapannya	per @@siap @@an @@nya
menggalang	men @@galang
rendahan	rendah @@an
penjaminnya	pen @@jamin @@nya
batal	batal
tajamnya	tajam @@nya
dekatnya	dekat @@nya
serbuan	serbu @@an
menceburkan	men @@cebur @@kan
federasi	federasi
natalnya	natal @@nya
dicalonkan	di @@calon @@kan
ditunjukan	di @@tunjuk @@an
mengabari	men @@kabar @@i
ucapannya	ucap @@an @@nya
perancangan	pen @@rancang @@an
bawah	bawah
agama	agama
selayaknya	se @@layak @@nya
dayanya	daya @@nya
dipajaki	di @@pajak @@i
cepat	cepat
kau	kau
dielaborasi	di @@elaborasi
komponennya	komponen @@nya
mempermudah	men @@mudah
pinang	pinang
kebal	kebal
takutnya	takut @@nya
menyangkanya	men @@sangka @@nya
penampung	pen @@tampung
tatapannya	tatap @@an @@nya
bersintesis	ber @@sintesis
sanksinya	sanksi @@nya
gajinya	gaji @@nya
dilupakannya	di @@lupa @@kan @@nya
menghina	men @@hina
terputus	ter @@putus
responden	responden
empunya	empunya
perbankan	per @@bank @@an
menggoda	men @@goda
cerai	cerai
buaian	buai @@an
bunyinya	bunyi @@nya
diterjemahkan	di @@terjemah @@kan
mencolok	men @@colok
suplemen	suplemen
tertutup	ter @@tutup
produksi	produksi
pengampun	pen @@ampun
turki	turki
orang	orang
ulasan	ulas @@an
dividen	dividen
berkondisi	ber @@kondisi
bervariasi	ber @@variasi
waktu	waktu
memainkannya	men @@main @@kan @@nya
mendominasi	men @@dominasi
berhubung	ber @@hubung
saudaramu	saudara @@mu
pendaratan	pen @@darat @@an
jarahan	jarah @@an
sepenuh	se @@penuh
beku	beku
dihentikan	di @@henti @@kan
mengarsipkan	men @@arsip @@kan
penutup	pen @@tutup
memancingnya	men @@pancing @@nya
pembawa	pen @@bawa
anjuran	anjur @@an
bermekaran	ber @@mekar @@an
tanamkan	tanam @@kan
pengembaliannya	pen @@kembali @@an @@nya
memenuhi	men @@penuh @@i
pasokan	pasok @@an
merekrut	men @@rekrut
menekan	men @@tekan
saji	saji
sulaman	sulam @@an
pukulan	pukul @@an
kandangnya	kandang @@nya
dibantu	di @@bantu
sucikan	suci @@kan
asisten	asisten
penyucian	pen @@suci @@an
berkendara	ber @@kendara
profesi	profesi
letih	letih
perhentian	per @@henti @@an
memasangnya	men @@pasang @@nya
bersumpah	ber @@sumpah
piala	piala
terkendali	ter @@kendali
goyah	goyah
menebang	men @@tebang
asalkan	asal @@kan
margasatwa	margasatwa
menolaknya	men @@tolak @@nya
khayalan	khayal @@an
penganut	pen @@anut
pasifik	pasifik
pembibitan	pen @@bibit @@an
penggantian	pen @@ganti @@an
pengaruhi	pengaruh @@i
disibukkan	di @@sibuk @@kan
berlanjut	ber @@lanjut
kumpulan	kumpul @@an
memancarkan	men @@pancar @@kan
jurang	jurang
lezatnya	lezat @@nya
memuja	men @@puja
menyalahgunakannya	men @@salahguna @@kan @@nya
kelas	kelas
mangsanya	mangsa @@nya
mementingkan	men @@penting @@kan
pigmen	pigmen
menginstruksikan	men @@instruksi @@kan
menjual	men @@jual
maraton	maraton
pungutnya	pungut @@nya
pelaksanaan	pen @@laksana @@an
membantunya	men @@bantu @@nya
emosional	emosional
pemahamannya	pen @@paham @@an @@nya
manipulasi	manipulasi
memetik	men @@petik
anjingnya	anjing @@nya
menahan	men @@tahan
kamp	kamp
pengajar	pen @@ajar
penggunaannya	pen @@guna @@an @@nya
mendengarkan	men @@dengar @@kan
penghakiman	pen @@hakim @@an
utamanya	utama @@nya
hakekatnya	hakekat @@nya
pelindung	pen @@lindung
penghalau	pen @@halau
luangkan	luang @@kan
respon	respon
diterangkan	di @@terang @@kan
bunganya	bunga @@nya
alumni	alumni
keluar	keluar
contohnya	contoh @@nya
bak	bak
upah	upah
terjual	ter @@jual
terhubungi	ter @@hubung @@i
nafas	nafas
sejenis	se @@jenis
menjabat	men @@jabat
maknanya	makna @@nya
menyaksikannya	men @@saksi @@kan @@nya
sedihnya	sedih @@nya
terlebih	ter @@lebih
pemahaman	pen @@paham @@an
kolam	kolam
mengusulkannya	men @@usul @@kan @@nya
tafsiran	tafsir @@an
surga	surga
hindari	hindar @@i
membaca	men @@baca
purba	purba
tehnya	teh @@nya
jantan	jantan
kupercaya	ku @@percaya
perkenalan	per @@kenal @@an
penghinaan	pen @@hina @@an
pinggang	pinggang
bersimpati	ber @@simpati
dibangun	di @@bangun
paragraf	paragraf
penagihannya	pen @@tagih @@an @@nya
sebulan	se @@bulan
bantal	bantal
kuingat	ku @@ingat
ketidakmampuan	ke @@tidak @@mampu @@an
dimeriahkan	di @@meriah @@kan
pertaniannya	per @@tani @@an @@nya
memamerkannya	men @@pamer @@kan @@nya
kentalnya	kental @@nya
lembaga	lembaga
selaras	selaras
pengadaan	pen @@ada @@an
menggagalkan	men @@gagal @@kan
menjagamu	men @@jaga @@mu
jauhkan	jauh @@kan
tetap	tetap
rancangan	rancang @@an
sepakat	sepakat
film	film
abstrak	abstrak
matiku	mati @@ku
kumpulkan	kumpul @@kan
dibunyikan	di @@bunyi @@kan
menerjemahkan	men @@terjemah @@kan
kuyakini	ku @@yakin @@i
panenan	panen @@an
dicuci	di @@cuci
dihilangkan	di @@hilang @@kan
didirikan	di @@diri @@kan
menggigitku	men @@gigit @@ku
komando	komando
mengotori	men @@kotor @@i
seru	seru
mendongkrak	men @@dongkrak
airnya	air @@nya
dibuka	di @@buka
berjauhan	ber @@jauh @@an
maret	maret
penasihat	penasihat
diuruskan	di @@urus @@kan
menyuntikkan	men @@suntik @@kan
tercurah	ter @@curah
memveto	men @@veto
rekanan	rekan @@an
pedih	pedih
mengintai	men @@intai
cahaya	cahaya
tahap	tahap
dermawan	derma @@wan
menghubungkan	men @@hubung @@kan
reka	reka
ditimpa	di @@timpa
pasca	pasca
abu	abu
belgia	belgia
pembiayaan	pen @@biaya @@an
paksaan	paksa @@an
imanmu	iman @@mu
mencerminkan	men @@cermin @@kan
penjembatanan	pen @@jembatan @@an
cangkul	cangkul
utara	utara
diluluskan	di @@lulus @@kan
diupah	di @@upah
mempertanggungjawabkannya	men @@tanggungjawab @@kan @@nya
dirancang	di @@rancang
menaklukkan	men @@takluk @@kan
penghulu	pen @@hulu
katamu	kata @@mu
jualan	jual @@an
memeriksakan	men @@periksa @@kan
automotif	automotif
rangkap	rangkap
senapan	senapan
tersaji	ter @@saji
daftar	daftar
ikat	ikat
mendasar	men @@dasar
unggas	unggas
implementasinya	implementasi @@nya
berakar	ber @@akar
diprakarsai	di @@prakarsa @@i
komplikasi	komplikasi
artis	artis
prosedur	prosedur
pembaruan	pen @@baru @@an
mencondongkan	men @@condong @@kan
sumbangannya	sumbang @@an @@nya
meneladani	men @@teladan @@i
pergaulan	per @@gaul @@an
taninya	tani @@nya
terhambatnya	ter @@hambat @@nya
tertua	ter @@tua
terkenal	ter @@kenal
mei	mei
pembobolan	pen @@bobol @@an
berfungsi	ber @@fungsi
selepas	se @@lepas
berkampanye	ber @@kampanye
klasifikasi	klasifikasi
memproteksi	men @@proteksi
mengudara	men @@udara
belikan	beli @@kan
pejabat	pejabat
mengumpat	men @@umpat
komposisi	komposisi
pemenuhannya	pen @@penuh @@an @@nya
lunturnya	luntur @@nya
dunianya	dunia @@nya
mengantri	men @@antri
menimbun	men @@timbun
pencabutan	pen @@cabut @@an
penguasaan	pen @@kuasa @@an
memikulnya	men @@pikul @@nya
melangkah	men @@langkah
pengubah	pen @@ubah
membenahi	men @@benah @@i
melarang	men @@larang
ragukan	ragu @@kan
kutub	kutub
israel	israel
diversifikasi	diversifikasi
produsen	produsen
penggaduhan	pen @@gaduh @@an
separuhnya	se @@paruh @@nya
dieksekusi	di @@eksekusi
investor	investor
meninggikan	men @@tinggi @@kan
licin	licin
sesamanya	se @@sama @@nya
mengikuti	men @@ikut @@i
jarinya	jari @@nya
subjektivitasnya	subjektivitas @@nya
retribusinya	retribusi @@nya
mendeskripsikan	men @@deskripsi @@kan
komplain	komplain
memikirkannya	men @@pikir @@kan @@nya
mengamatinya	men @@amati @@nya
pengucuran	pen @@kucur @@an
pembebasan	pen @@bebas @@an
nasabahnya	nasabah @@nya
renovasinya	renovasi @@nya
turis	turis
terbantahkan	ter @@bantah @@kan
dibawanya	di @@bawa @@nya
militernya	militer @@nya
dikurangi	di @@kurang @@i
asuh	asuh
pariwisata	pariwisata
mengisolasi	men @@isolasi
mempercayakan	men @@percaya @@kan
kebobolan	ke @@bobol @@an
dikembalikannya	di @@kembali @@kan @@nya
dibohongi	di @@bohong @@i
diskualifikasi	diskualifikasi
mengatakan	men @@kata @@kan
mendambakan	men @@damba @@kan
mendaratkannya	men @@darat @@kan @@nya
penyiapan	pen @@siap @@an
terulang	ter @@ulang
paskah	paskah
menagih	men @@tagih
membungkam	men @@bungkam
mengalirkan	men @@alir @@kan
penggembalaan	pen @@gembala @@an
zaitun	zaitun
perdesaan	per @@desa @@an
mendatanginya	men @@datang @@i @@nya
menabrakkannya	men @@tabrak @@kan @@nya
reuni	reuni
perbuatan	per @@buat @@an
bertanda	ber @@tanda
beradik	ber @@adik
kusebut	ku @@sebut
dipikirkan	di @@pikir @@kan
wc	wc
timbulnya	timbul @@nya
arahnya	arah @@nya
mengintimidasi	men @@intimidasi
coraknya	corak @@nya
mengambilnya	men @@ambil @@nya
jangka	jangka
spontan	spontan
komplek	komplek
lalui	lalu @@i
pengurusan	pen @@urus @@an
serangan	serang @@an
terlipat	ter @@lipat
uluran	ulur @@an
terhisap	ter @@hisap
gengsi	gengsi
diperingatkan	di @@per @@ingat @@kan
peninjau	pen @@tinjau
dilelang	di @@lelang
memantulkan	men @@pantul @@kan
mandi	mandi
pemetaan	pen @@peta @@an
tubuhku	tubuh @@ku
dipenjarakan	di @@penjara @@kan
semeriah	se @@meriah
ujar	ujar
menegosiasikan	men @@negosiasi @@kan
persoalannya	per @@soal @@an @@nya
membungkamkan	men @@bungkam @@kan
mengosongkan	men @@kosong @@kan
berkenan	ber @@kenan
bidangnya	bidang @@nya
bulat	bulat
sekolahan	sekolah @@an
terkini	terkini
anaknya	anak @@nya
sosialnya	sosial @@nya
kakiku	kaki @@ku
dibangkitkan	di @@bangkit @@kan
terdaftar	ter @@daftar
meninggalkan	men @@tinggal @@kan
sisa	sisa
manfaat	manfaat
menuduh	men @@tuduh
contoh	contoh
struktur	struktur
bantuannya	bantu @@an @@nya
menyembuhkannya	men @@sembuh @@kan @@nya
juli	juli
kamarnya	kamar @@nya
gelas	gelas
depanmu	depan @@mu
listriknya	listrik @@nya
guna	guna
terindikasi	ter @@indikasi
telepon	telepon
ahlinya	ahli @@nya
nyaris	nyaris
anggrek	anggrek
top	top
allah	allah
bungsu	bungsu
rekapitulasi	rekapitulasi
sopan	sopan
penyalurannya	pen @@salur @@an @@nya
dicengkeram	di @@cengkeram
merosotnya	merosot @@nya
gilanya	gila @@nya
diadakan	di @@ada @@kan
diperlukan	di @@perlu @@kan
diganti	di @@ganti
konstitusional	konstitusional
niatan	niat @@an
pembuatan	pen @@buat @@an
tontonan	tonton @@an
mengkoordinasikan	men @@koordinasi @@kan
belanjakan	belanja @@kan
penghasilannya	pen @@hasil @@an @@nya
perayaan	pen @@raya @@an
diutarakan	di @@utara @@kan
minggu	minggu
seperangkat	se @@perangkat
berkeinginan	ber @@ke @@ingin @@an
tebusan	tebus @@an
padi	padi
memberikannya	men @@beri @@kan @@nya
memproyeksikan	men @@proyeksi @@kan
perhutanan	per @@hutan @@an
ulah	ulah
dicerna	di @@cerna
menyembur	men @@sembur
putrinya	putri @@nya
menyinergikan	men @@sinergi @@kan
denpasar	denpasar
dipisah	di @@pisah
mengorbankan	men @@korban @@kan
berkebalikan	ber @@ke @@balik @@an
terekspresikan	ter @@ekspresi @@kan
koper	koper
mengarungi	men @@karung @@i
memperbaharui	men @@baharu @@i
menyusahkan	men @@susah @@kan
memprediksi	men @@prediksi
liberalisasi	liberalisasi
bahagia	bahagia
sorenya	sore @@nya
sendirian	sendiri @@an
diprioritaskan	di @@prioritas @@kan
mencakup	men @@cakup
antarkeluarga	antar @@keluarga
menimbang	men @@timbang
proyeksi	proyeksi
dibina	di @@bina
kendaraannya	kendara @@an @@nya
berbobot	ber @@bobot
dinginnya	dingin @@nya
mengesankan	men @@kesan @@kan
membujuknya	men @@bujuk @@nya
melamar	men @@lamar
bersamaan	ber @@sama @@an
menugaskan	men @@tugas @@kan
lampu	lampu
antrinya	antri @@nya
bertindak	ber @@tindak
akuntabilitas	akuntabilitas
penuntutan	pen @@tuntut @@an
penyerbuan	pen @@serbu @@an
mengusulkan	men @@usul @@kan
kampung	kampung
rasul	rasul
disurvei	di @@survei
menengah	men @@tengah
menyobek	men @@sobek
aktifnya	aktif @@nya
kandungmu	kandung @@mu
mengapit	men @@apit
minoritas	minoritas
dibiaya	di @@biaya
tengah	tengah
menggiring	men @@giring
sentimeter	sentimeter
capaiannya	capai @@an @@nya
selebar	se @@lebar
makhluk	makhluk
pinjaman	pinjam @@an
mediasi	mediasi
terpetakan	ter @@peta @@kan
merpati	merpati
interaksi	interaksi
rujukan	rujuk @@an
diprovokasi	di @@provokasi
melenceng	men @@lenceng
mirip	mirip
nafsumu	nafsu @@mu
memeluk	men @@peluk
tragis	tragis
damaskus	damaskus
menugasi	men @@tugas @@i
dagangnya	dagang @@nya
melunasi	men @@lunas @@i
siang	siang
kalangan	kalangan
dibesarkan	di @@besar @@kan
meletusnya	men @@letus @@nya
penyegaran	pen @@segar @@an
unta	unta
ditabur	di @@tabur
walikota	walikota
penebal	pen @@tebal
menandakan	men @@tanda @@kan
menyeberanginya	men @@seberang @@i @@nya
lipat	lipat
membedakan	men @@beda @@kan
nasabah	nasabah
diadili	di @@adil @@i
rancu	rancu
penindasan	pen @@tindas @@an
membentang	men @@bentang
stakeholder	stakeholder
terlama	ter @@lama
pemilih	pen @@pilih
dikombinasikan	di @@kombinasi @@kan
sumatra	sumatra
tempel	tempel
depannya	depan @@nya
adam	adam
ongkosnya	ongkos @@nya
ras	ras
diumpankan	di @@umpan @@kan
penumpang	pen @@tumpang
pemegang	pen @@pegang
melampaui	men @@lampau @@i
eksperimen	eksperimen
bergizi	ber @@gizi
mempertimbangkan	men @@timbang @@kan
mencairnya	men @@cair @@nya
pasta	pasta
andal	andal
kamis	kamis
menelusuri	men @@telusuri
dokternya	dokter @@nya
penalaran	pen @@nalar @@an
lisan	lisan
percaya	percaya
nonperdagangan	non @@per @@dagang @@an
lapang	lapang
imbas	imbas
sangkakala	sangkakala
menguduskan	men @@kudus @@kan
komedi	komedi
teralihkan	ter @@alih @@kan
reputasinya	reputasi @@nya
kemarin	kemarin
berkekuatan	ber @@ke @@kuat @@an
menceraikan	men @@cerai @@kan
pembedaan	pen @@beda @@an
tambahan	tambah @@an
penelaahan	pen @@telaah @@an
berjangka	ber @@jangka
anti	anti
kendalikan	kendali @@kan
selasa	selasa
hamparan	hampar @@an
membagi	men @@bagi
dakwaan	dakwa @@an
tercoreng	ter @@coreng
bau	bau
persembahan	per @@sembah @@an
waspada	waspada
memahaminya	men @@paham @@i @@nya
menyingkirkan	men @@singkir @@kan
muara	muara
menyamakan	men @@sama @@kan
urusanku	urus @@an @@ku
pameran	pamer @@an
bola	bola
didukungnya	di @@dukung @@nya
dilihat	di @@lihat
puskesmas	puskesmas
dikabulkan	di @@kabul @@kan
rupa	rupa
saksi	saksi
sempitnya	sempit @@nya
penengah	pen @@tengah
dinikahinya	di @@nikah @@i @@nya
diperbuat	di @@per @@buat
terkuno	ter @@kuno
berbisnis	ber @@bisnis
rutin	rutin
akurasinya	akurasi @@nya
pendanaan	pen @@dana @@an
selektif	selektif
membuatmu	men @@buat @@mu
bermacam	ber @@macam
diambil	di @@ambil
menaikan	men @@tai @@kan
menggantinya	men @@ganti @@nya
berwawasan	ber @@wawasan
dijawab	di @@jawab
mengguncang	men @@guncang
motonya	moto @@nya
terompetnya	terompet @@nya
relaksasi	relaksasi
ratapan	ratap @@an
seharga	se @@harga
lawan	lawan
disumbangkan	di @@sumbang @@kan
kenakan	kena @@kan
integritas	integritas
haus	haus
pembuangan	pen @@buang @@an
menumpasnya	men @@tumpas @@nya
terparah	ter @@parah
pesta	pesta
perbatasan	per @@batas @@an
perhimpunan	per @@himpun @@an
ketidaksuksesan	ke @@tidak @@sukses @@an
efektivitas	efektivitas
diwakilkan	di @@wakil @@kan
dicocokkan	di @@cocok @@kan
disebut	di @@sebut
setahun	se @@tahun
balau	balau
penyusunannya	pen @@susun @@an @@nya
terbaru	ter @@baru
tersendat	tersendat
membunuh	men @@bunuh
menghimbau	men @@himbau
menuliskannya	men @@tulis @@kan @@nya
pembekuan	pen @@beku @@an
malaikat	malaikat
menonton	men @@tonton
meluruskan	men @@lurus @@kan
salib	salib
mendistribusikannya	men @@distribusi @@kan @@nya
internet	internet
penanganan	pen @@tangan @@an
konvensional	konvensional
sumbangan	sumbang @@an
privasi	privasi
menyuguhkan	men @@suguh @@kan
sektarian	sektarian
mendorongnya	men @@dorong @@nya
merubah	men @@rubah
dituakan	di @@tua @@kan
nonpenerima	non @@pen @@terima
navigasi	navigasi
mengaktifkannya	men @@aktif @@kan @@nya
ubah	ubah
berkecukupan	ber @@ke @@cukup @@an
langkanya	langka @@nya
meratifikasi	men @@ratifikasi
merebut	men @@rebut
asa	asa
menahannya	men @@tahan @@nya
berbahan	ber @@bah @@an
dipesan	di @@pesan
pintas	pintas
betul	betul
tabah	tabah
diverifikasinya	di @@verifikasi @@nya
kotor	kotor
dijajaki	di @@jajak @@i
penyemprotan	pen @@semprot @@an
dijumpainya	di @@jumpa @@i @@nya
pendelegasian	pen @@delegasi @@an
pendiam	pen @@diam
kagumi	kagum @@i
kritikan	kritik @@an
bulu	bulu
gagang	gagang
didiktekan	di @@dikte @@kan
melanjutkannya	men @@lanjut @@kan @@nya
diperdagangkan	di @@per @@dagang @@kan
hemat	hemat
meletihkan	men @@letih @@kan
klorofilnya	klorofil @@nya
mewujudkannya	men @@wujud @@kan @@nya
memudarkan	men @@pudar @@kan
bersihkan	bersih @@kan
prosesi	proses @@i
terseleksi	ter @@seleksi
membengkokkan	men @@bengkok @@kan
simpanan	simpan @@an
terbebani	ter @@beban @@i
demonstrasi	demonstrasi
pengkajian	pen @@kaji @@an
antikemiskinan	anti @@ke @@miskin @@an
dimensi	dimensi
dikompromikan	di @@kompromi @@kan
deretan	deret @@an
berlatih	ber @@latih
hobi	hobi
partisipasi	partisipasi
permulaan	per @@mula @@an
rendahkan	rendah @@kan
blok	blok
mengakhirinya	men @@akhir @@i @@nya
gawat	gawat
disadari	di @@sadar @@i
antarkeyakinan	antar @@ke @@yakin @@an
mencampur	men @@campur
disusunnya	di @@susun @@nya
disisi	di @@sisi
didorong	di @@dorong
wanita	wanita
naikkan	naik @@kan
tipu	tipu
bea	bea
mempersempit	men @@sempit
diupayakan	di @@upaya @@kan
dipersentasekan	di @@persentase @@kan
pelanggaran	pen @@langgar @@an
dalih	dalih
laut	laut
penerbang	pen @@terbang
penghibur	pen @@hibur
patuh	patuh
ditekuninya	di @@tekun @@i @@nya
stok	stok
dikendarainya	di @@kendara @@i @@nya
menua	men @@tua
kapasitasnya	kapasitas @@nya
melukai	men @@luka @@i
kutempatkan	ku @@tempat @@kan
mengiring	men @@iring
bertetanggaan	ber @@tetangga @@an
efisiennya	efisien @@nya
mendesak	men @@desak
programnya	program @@nya
menghapus	men @@hapus
mengharuskan	men @@harus @@kan
skeptis	skeptis
seenaknya	se @@enak @@nya
tepat	tepat
eksternal	eksternal
jiwaku	jiwa @@aku
suntik	suntik
rohani	rohani
menghamparkan	men @@hampar @@kan
penyesalan	pen @@sesal @@an
konflik	konflik
fosil	fosil
sertifikat	sertifikat
tunjangan	tunjang @@an
ditangan	di @@tangan
melatih	men @@latih
apresiasi	apresiasi
disembelih	di @@sembelih
musikal	musikal
swedia	swedia
diagnostik	diagnostik
hasrat	hasrat
berpulang	ber @@pulang
tol	tol
berotot	ber @@otot
spanyol	spanyol
tenaga	tenaga
keping	keping
dihalangi	di @@halang @@i
berpisah	ber @@pisah
yakinkan	yakin @@kan
debutnya	debut @@nya
langsing	langsing
penyelidikan	pen @@selidik @@an
antarpemangku	antar @@pen @@pangku
diperbolehkan	di @@per @@boleh @@kan
perhambaan	per @@hamba @@an
andil	andil
ledakan	ledak @@an
kreativitas	kreativitas
memuliakan	men @@mulia @@kan
pencatat	pen @@catat
kapas	kapas
tergali	ter @@gali
kandangmu	kandang @@mu
dijamin	di @@jamin
congkak	congkak
sukacitamu	sukacita @@mu
persetujuannya	per @@setuju @@an @@nya
celana	celana
wali	wali
terformulasi	ter @@formulasi
barunya	baru @@nya
abaikan	abai @@kan
kunyah	kunyah
pendiri	pen @@diri
santri	santri
dihadapkan	di @@hadap @@kan
cicilan	cicil @@an
terletak	ter @@letak
diistilahkan	di @@istilah @@kan
seimannya	se @@iman @@nya
saing	saing
patokan	patok @@an
penuhi	penuh @@i
berkendaraan	ber @@kendara @@an
optimalisasi	optimalisasi
memaksakan	men @@paksa @@kan
keguguran	ke @@gugur @@an
mencoreng	men @@coreng
genetik	genetik
tarik	tarik
memerlukan	men @@perlu @@kan
publikasi	publikasi
mendelegasikan	men @@delegasi @@kan
menggantikannya	men @@ganti @@kan @@nya
sawahnya	sawah @@nya
diwarisinya	di @@waris @@i @@nya
pengalokasian	pen @@alokasi @@an
sampul	sampul
menuangkan	men @@tuang @@kan
peritel	pen @@ritel
jamuan	jamu @@an
memperlebar	men @@lebar
dikemas	di @@kemas
mendesentralisasikannya	men @@desentralisasi @@kan @@nya
mengidentifikasi	men @@identifikasi
united	united
penerima	pen @@terima
prasarananya	prasarana @@nya
silang	silang
mudah	mudah
periang	pen @@riang
zona	zona
tanamnya	tanam @@nya
steril	steril
saingan	saing @@an
agungnya	agung @@nya
prevalensinya	prevalensi @@nya
menko	menko
diketahuinya	di @@ketahui @@nya
gampang	gampang
bisnis	bisnis
aduannya	adu @@an @@nya
diharap	di @@harap
yahudi	yahudi
dipedulikan	di @@peduli @@kan
memperparah	men @@parah
seumpama	se @@umpama
benaknya	benak @@nya
februari	februari
penentu	pen @@tentu
dicerminkan	di @@cermin @@kan
tari	tari
lain	lain
sebenarnya	se @@benar @@nya
dipukuli	di @@pukul @@i
hormat	hormat
planet	planet
ketidakpatuhan	ke @@tidak @@patuh @@an
panahnya	panah @@nya
duga	duga
mensahkan	men @@sah @@kan
melatarbelakanginya	men @@latarbelakang @@i @@nya
pembuat	pen @@buat
pendisiplinan	pen @@disiplin @@an
punglinya	pungli @@nya
zakat	zakat
digali	di @@gali
kusut	kusut
berargumen	ber @@argumen
dukungannya	dukung @@an @@nya
repot	repot
sebaliknya	sebaliknya
menempati	men @@tempat @@i
capai	capai
tabungannya	tabung @@an @@nya
intimidasi	intimidasi
memperjuangkan	men @@juang @@kan
pekerjaannya	pekerja @@an @@nya
cela	cela
atraksi	atraksi
diunggah	di @@unggah
jembatan	jembatan
diterbangkan	di @@terbang @@kan
bagiannya	bagi @@an @@nya
sapu	sapu
penyulingan	pen @@suling @@an
pengambilannya	pen @@ambil @@an @@nya
jumlah	jumlah
perikanannya	per @@ikan @@an @@nya
mentri	mentri
pencantuman	pen @@cantum @@an
berjenjang	ber @@jenjang
mengadministrasikan	men @@administrasi @@kan
menggali	men @@gali
imam	imam
akurasi	akurasi
ilegal	ilegal
dibelenggu	di @@belenggu
persamaan	per @@sama @@an
pendalaman	pen @@dalam @@an
operasionalnya	operasional @@nya
nonpertaniannya	non @@per @@tani @@an @@nya
pembentukan	pen @@bentuk @@an
stempelnya	stempel @@nya
mengurut	men @@urut
berhiaskan	ber @@hias @@kan
sinerginya	sinergi @@nya
menyelamatkannya	men @@selamat @@kan @@nya
lunak	lunak
klub	klub
pertanahan	per @@tanah @@an
pengolah	pen @@olah
beda	beda
kurun	kurun
mengejarnya	men @@kejar @@nya
bekas	bekas
terjerumus	ter @@jerumus
dicanangkannya	di @@canang @@kan @@nya
syaraf	syaraf
menancapkan	men @@tancap @@kan
susunan	susun @@an
rate	rate
pengintegrasian	pen @@integrasi @@an
firman	firman
indikasi	indikasi
diimunisasi	di @@imunisasi
bertekun	ber @@tekun
kejatuhannya	ke @@jatuh @@an @@nya
memasuki	men @@masuk @@i
kekeliruan	ke @@keliru @@an
bertalian	ber @@tali @@an
eksekusinya	eksekusi @@nya
tragedi	tragedi
kadarnya	kadar @@nya
menggugat	men @@gugat
berputar	ber @@putar
pejabatnya	pejabat @@nya
debitur	debitur
mengkaji	men @@kaji
mengacu	men @@acu
nonkonsumsi	non @@konsumsi
berkat	berkat
berbahasa	ber @@bahasa
mengenyahkan	men @@enyah @@kan
menuju	men @@tuju
ucapkan	ucap @@kan
modalnya	modal @@nya
penyaringan	pen @@saring @@an
radiasi	radiasi
mengamankan	men @@aman @@kan
tertancap	ter @@tancap
diukir	di @@ukir
terbesar	ter @@besar
sengketa	sengketa
menepi	men @@tepi
memurnikan	men @@murni @@kan
menawan	men @@tawan
migrasi	migrasi
cemerlang	cemerlang
dipakai	di @@pakai
merapi	men @@rapi
kutuju	ku @@tuju
pernikahan	per @@nikah @@an
berhadapan	ber @@hadap @@an
menghormati	men @@hormat @@i
ditemani	di @@teman @@i
gunung	gunung
memfotokopi	men @@fotokopi
sekadar	se @@kadar
diperkenan	di @@per @@kenan
galeri	galeri
diternakkan	di @@ternak @@kan
tepi	tepi
tempuhnya	tempuh @@nya
klip	klip
tercapainya	ter @@capai @@nya
terjerat	ter @@jerat
kehadiran	ke @@hadir @@an
dipikat	di @@pikat
guncangan	guncang @@an
dipasarkan	di @@pasar @@kan
kudengar	ku @@dengar
merenungkannya	men @@renung @@kan @@nya
verifikasinya	verifikasi @@nya
iri	iri
disusun	di @@susun
membiarkan	men @@biar @@kan
bekerja	bekerja
konsep	konsep
menjengkelkan	men @@jengkel @@kan
pencoretan	pen @@coret @@an
pembahasannya	pen @@bahas @@an @@nya
menerkam	men @@terkam
menyimak	men @@simak
tersirat	ter @@sirat
pemberkatan	pen @@berkat @@an
saleh	saleh
pendaftaran	pen @@daftar @@an
bobrok	bobrok
berhala	berhala
dirintis	di @@rintis
mengalihkan	men @@alih @@kan
membacakan	men @@baca @@kan
setujui	setuju @@i
uap	uap
menyoroti	men @@sorot @@i
minimum	minimum
bersoal	ber @@soal
menganiaya	men @@aniaya
kekal	kekal
pita	pita
antarlembaga	antar @@lembaga
dikucilkan	di @@kucil @@kan
khusus	khusus
ditolong	di @@tolong
membanggakan	men @@bangga @@kan
koreksi	koreksi
bercocok	ber @@cocok
menghancurkan	men @@hancur @@kan
ukur	ukur
berfikir	ber @@fikir
menara	menara
mengolahnya	men @@olah @@nya
dek	dek
kritis	kritis
berlalu	ber @@lalu
berkomunikasi	ber @@komunikasi
diperhadapkan	di @@per @@hadap @@kan
lokal	lokal
pelanggar	pen @@langgar
melebihkan	men @@lebih @@kan
huruf	huruf
terguncangkan	ter @@guncang @@kan
dipermainkan	di @@per @@main @@kan
perangkat	perangkat
peralihan	per @@alih @@an
sebidang	se @@bidang
dipaparkan	di @@papar @@kan
alamnya	alam @@nya
menggapai	men @@gapai
penyayang	pen @@sayang
duplikasi	duplikasi
goreng	goreng
perbedaannya	per @@beda @@an @@nya
pengguliran	pen @@gulir @@an
panel	panel
optimalnya	optimal @@nya
tamu	tamu
konser	konser
terpajangnya	ter @@pajang @@nya
digaji	di @@gaji
telanjang	telanjang
petunjuk	petunjuk
bebas	bebas
tertib	tertib
bosnya	bos @@nya
tumbuhan	tumbuh @@an
soal	soal
sebut	sebut
kumuh	kumuh
dibagi	di @@bagi
substansinya	substansi @@nya
mengikutkan	men @@ikut @@kan
takluk	takluk
pelataran	pen @@latar @@an
menunggang	men @@tunggang
lucunya	lucu @@nya
anugerah	anugerah
jahitan	jahit @@an
didistribusikan	di @@distribusi @@kan
perantara	perantara
buruh	buruh
lapaknya	lapak @@nya
menindaklanjuti	men @@tindaklanjut @@i
diinvestasikan	di @@investasi @@kan
korupsinya	korupsi @@nya
menekuni	men @@tekun @@i
suriah	suriah
kereta	kereta
perkoperasian	per @@koperasi @@an
kartun	kartun
kosong	kosong
berobat	ber @@obat
matahari	matahari
menginterupsi	men @@interupsi
didialogkan	di @@dialog @@kan
teleskop	teleskop
pentingnya	penting @@nya
penderitaan	pen @@derita @@an
diatur	di @@atur
jiwanya	jiwa @@nya
lingkaran	lingkar @@an
tersimpan	ter @@simpan
beranak	ber @@anak
guntingan	gunting @@an
menjala	men @@jala
diusulkan	di @@usul @@kan
antardaerah	antar @@daerah
penyempurnaan	pen @@sempurna @@an
tuturnya	tutur @@nya
membersihkan	men @@bersih @@kan
pamannya	paman @@nya
filipina	filipina
berlawanan	ber @@lawan @@an
favoritnya	favorit @@nya
rencananya	rencana @@nya
camat	camat
merepotkan	men @@repot @@kan
jariku	jari @@ku
allahku	allah @@ku
digabungkan	di @@gabung @@kan
penggagasnya	pen @@gagas @@nya
coba	coba
tertidur	ter @@tidur
mengedarkan	men @@edar @@kan
astronot	astronot
mengusahakan	men @@usaha @@kan
dipelihara	di @@pelihara
teragung	ter @@agung
obsesi	obsesi
data	data
rindu	rindu
benarnya	benar @@nya
tercemar	ter @@cemar
pembedahan	pen @@bedah @@an
terkoordinasi	ter @@koordinasi
mengizinkan	men @@izin @@kan
tinggalnya	tinggal @@nya
antikomunis	anti @@komunis
internasional	internasional
mentransformasikan	men @@transformasi @@kan
terakumulasi	ter @@akumulasi
penjahit	pen @@jahit
pertanggungjawabannya	per @@tanggungjawab @@an @@nya
diakibatkannya	di @@akibat @@kan @@nya
kompensasi	kompensasi
pengaturan	pen @@atur @@an
warisnya	waris @@nya
penyimpanan	pen @@simpan @@an
kontraktor	kontraktor
membayangi	men @@bayang @@i
sanksi	sanksi
tersingkat	ter @@singkat
dipuji	di @@puji
pemalsuan	pen @@palsu @@an
cukurnya	cukur @@nya
kuil	kuil
momen	momen
salehnya	saleh @@nya
malapetaka	malapetaka
tutur	tutur
prospeknya	prospek @@nya
lesu	lesu
antarvariabel	antar @@variabel
menyeberang	men @@seberang
semata	se @@mata
meletakkan	men @@letak @@kan
tindak	tindak
seyakin	se @@yakin
menjanda	men @@janda
pertanyaan	per @@tanya @@an
diraup	di @@raup
tikus	tikus
keluhannya	keluh @@an @@nya
dihafalkan	di @@hafal @@kan
tantangannya	tantang @@an @@nya
membesarkan	men @@besar @@kan
wawasannya	wawasan @@nya
curah	curah
kontes	kontes
diprotes	di @@protes
terpadu	ter @@padu
pemiliknya	pen @@milik @@nya
merisaukan	men @@risau @@kan
menatapnya	men @@tatap @@nya
diskon	diskon
merumuskannya	men @@rumus @@kan @@nya
infrastrukturnya	infrastruktur @@nya
dicerai	di @@cerai
tersentuh	ter @@sentuh
baterai	baterai
lembut	lembut
persatuan	per @@satu @@an
distributor	distributor
tiruan	tiru @@an
dilanjutkan	di @@lanjut @@kan
menggosok	men @@gosok
berdusta	ber @@dusta
menguraikan	men @@urai @@kan
berafiliasi	ber @@afiliasi
sesat	sesat
delima	delima
didoakan	di @@doa @@kan
penggunanya	pen @@guna @@nya
sangkaan	sangka @@an
kaosnya	kaos @@nya
naiknya	naik @@nya
belanjaan	belanja @@an
busuknya	busuk @@nya
pemeran	pen @@peran
fiskal	fiskal
fajar	fajar
akut	akut
tangganya	tangga @@nya
tindih	tindih
hubunganmu	hubung @@an @@mu
batin	batin
pengesahan	pen @@sah @@an
tundukkan	tunduk @@kan
zat	zat
licik	licik
kepindahan	ke @@pindah @@an
emosinya	emosi @@nya
dihapuskan	di @@hapus @@kan
penggerak	pen @@gerak
pra	pra
menyembah	men @@sembah
frekuensinya	frekuensi @@nya
kombinasi	kombinasi
mulutnya	mulut @@nya
terserak	ter @@serak
muridnya	murid @@nya
teraman	ter @@aman
dipikirkannya	di @@pikir @@kan @@nya
menginginkanku	men @@ingin @@kan @@ku
rekonsiliasi	rekonsiliasi
dihiasi	di @@hias @@i
mempersulit	men @@sulit
otak	otak
berderet	ber @@deret
klaim	klaim
celaka	celaka
memusnahkan	men @@musnah @@kan
hanyut	hanyut
limpahan	limpah @@an
penerjemahan	pen @@terjemah @@an
imbalan	imbalan
luas	luas
sempurna	sempurna
uraian	urai @@an
menyimpan	men @@simpan
tunggal	tunggal
selain	se @@lain
mengorelasikan	men @@korelasi @@kan
memboikotnya	men @@boikot @@nya
tuhanku	tuhan @@ku
beasiswa	beasiswa
pungut	pungut
gadai	gadai
membebani	men @@beban @@i
wasit	wasit
ekspansi	ekspansi
membenarkan	men @@benar @@kan
disuapi	di @@suap @@i
sumatera	sumatera
antarruangan	antar @@ruang @@an
bayinya	bayi @@nya
komersil	komersil
berpacu	ber @@pacu
didedikasikan	di @@dedikasi @@kan
dicantumkan	di @@cantum @@kan
berkarat	ber @@karat
dirumahmu	di @@rumah @@mu
ditempuhnya	di @@tempuh @@nya
penafsir	pen @@tafsir
meluruskannya	men @@lurus @@kan @@nya
mengenalkan	men @@kenal @@kan
didapat	di @@dapat
pencocokan	pen @@cocok @@an
disucikan	di @@suci @@kan
patroli	patroli
mewaspadai	men @@waspada @@i
khotbahnya	khotbah @@nya
madu	madu
kimiawi	kimiawi
kebun	kebun
bersalin	ber @@salin
tinju	tinju
belanja	belanja
saran	saran
diangkutnya	di @@angkut @@nya
menyepakati	men @@sepakat @@i
logis	logis
antariksa	antariksa
oposisi	oposisi
lunas	lunas
mencairkannya	men @@cair @@kan @@nya
melangkahi	men @@langkah @@i
segel	segel
tanah	tanah
dites	di @@tes
memeliharamu	men @@pelihara @@mu
bumbu	bumbu
membeberkan	men @@beber @@kan
luntur	luntur
sukarelawan	sukarela @@wan
ditoleransi	di @@toleransi
tepatnya	tepat @@nya
berawal	ber @@awal
melanggarnya	men @@langgar @@nya
menang	menang
menindaklanjutinya	men @@tindaklanjut @@i @@nya
bermitra	ber @@mitra
mejanya	meja @@nya
amarah	amarah
kandungannya	kandung @@an @@nya
tolong	tolong
melihatnya	men @@lihat @@nya
berkeluh	ber @@keluh
seprovinsi	se @@provinsi
bermuatan	ber @@muat @@an
dijangkau	di @@jangkau
tertanam	ter @@tanam
meresponnya	men @@respon @@nya
mengorganisasikan	men @@organisasi @@kan
rokok	rokok
penganiaya	pen @@aniaya
nonkayu	non @@kayu
dicacah	di @@cacah
lubangnya	lubang @@nya
menggetarkan	men @@getar @@kan
dipekerjakan	di @@pekerja @@kan
disiarkan	di @@siar @@kan
mendatang	men @@datang
aspirasi	aspirasi
konsekuensinya	konsekuensi @@nya
pengangkat	pen @@angkat
monumennya	monumen @@nya
kecaman	kecam @@an
pengumpul	pen @@kumpul
memperberat	men @@berat
mendaftarkan	men @@daftar @@kan
pikirkan	pikir @@kan
mengkomunikasikannya	men @@komunikasi @@kan @@nya
membatasinya	men @@batas @@i @@nya
kalung	kalung
konsistennya	konsisten @@nya
hurufnya	huruf @@nya
kamus	kamus
terbawah	ter @@bawah
disahkan	di @@sah @@kan
melalaikan	men @@lalai @@kan
pengaturnya	pen @@atur @@nya
muram	muram
pemandangan	pen @@pandang @@an
gawangnya	gawang @@nya
jalanya	jala @@nya
banyaknya	banyak @@nya
total	total
dikenal	di @@kenal
bara	bara
menerobos	men @@terobos
terstruktur	ter @@struktur
manja	manja
siaga	siaga
diakomodasikan	di @@akomodasi @@kan
kumuhnya	kumuh @@nya
direnovasinya	di @@renovasi @@nya
kapalnya	kapal @@nya
mensyukuri	men @@syukuri
permasyarakatan	per @@masyarakat @@an
menggugah	men @@gugah
sengsara	sengsara
karet	karet
mempermasalahkan	men @@masalah @@kan
ditanyakan	di @@tanya @@kan
tetangganya	tetangga @@nya
meringkaskan	men @@ringkas @@kan
drastis	drastis
pemesanan	pen @@pesan @@an
persetujuan	per @@setuju @@an
mengkhawatirkan	men @@khawatir @@kan
penyiangan	pen @@siang @@an
diusir	di @@usir
dusta	dusta
jendela	jendela
bernoda	ber @@noda
memadai	memadai
terpesona	ter @@pesona
subjek	subjek
unit	unit
pilih	pilih
seumur	se @@umur
menguburkan	men @@kubur @@kan
muda	muda
famili	famili
mengamanatkan	men @@amanat @@kan
penajaman	pen @@tajam @@an
lambannya	lamban @@nya
butuhkan	butuh @@kan
pengumumannya	pen @@umum @@an @@nya
artinya	arti @@nya
flint	flint
dituangkan	di @@tuang @@kan
pertemanan	per @@teman @@an
bergemar	ber @@gemar
komandan	komandan
pengucapan	pen @@ucap @@an
membuatkan	men @@buat @@kan
berserakan	ber @@serak @@an
berawak	ber @@awak
berkabut	ber @@kabut
pimpinan	pimpin @@an
saudaranya	saudara @@nya
rumit	rumit
ingatannya	ingat @@an @@nya
bertanah	ber @@tanah
tewasnya	tewas @@nya
bantahan	bantah @@an
emisi	emisi
mempesona	men @@pesona
dicarinya	di @@cari @@nya
utusannya	utus @@an @@nya
pendukungnya	pen @@dukung @@nya
mikroskop	mikroskop
kas	kas
gugatan	gugat @@an
terbanyak	ter @@banyak
merambat	men @@rambat
mengadu	men @@adu
rak	rak
khasiatnya	khasiat @@nya
sulam	sulam
memenangi	men @@menang @@i
terikat	ter @@ikat
prihatin	prihatin
membagikan	men @@bagi @@kan
mendefinisikannya	men @@definisi @@kan @@nya
warisan	waris @@an
salah	salah
pesan	pesan
terseret	ter @@seret
menebarkan	men @@tebar @@kan
jamak	jamak
kawasan	kawasan
memedomani	men @@pedoman @@i
warisannya	waris @@an @@nya
perunggu	perunggu
pengungkapan	pen @@ungkap @@an
negeri	negeri
suruh	suruh
komisaris	komisaris
bulanannya	bulan @@an @@nya
pertobatan	per @@tobat @@an
menjurus	men @@jurus
menghindari	men @@hindar @@i
terpadat	ter @@padat
timbangan	timbang @@an
pelaksananya	pen @@laksana @@nya
terhenti	ter @@henti
membajak	men @@bajak
dicurigai	di @@curiga @@i
membungkus	men @@bungkus
aktivitas	aktivitas
posyandu	posyandu
dilunasi	di @@lunas @@i
swalayan	swalayan
dicuri	di @@curi
mengairi	men @@air @@i
disodorkan	di @@sodor @@kan
memayungi	men @@payung @@i
keterampilan	keterampilan
ditahun	di @@tahun
dongeng	dongeng
sup	sup
asetnya	aset @@nya
sorotan	sorot @@an
mewakilkan	men @@wakil @@kan
pembuktian	pen @@bukti @@an
penalti	penalti
laporkan	lapor @@kan
mengindikasikan	men @@indikasi @@kan
hantu	hantu
konsumsi	konsumsi
menggelisahkan	men @@gelisah @@kan
negara	negara
menyiangi	men @@siang @@i
bernomor	ber @@nomor
diteliti	di @@teliti
memotong	men @@potong
menghalau	men @@halau
lipatan	lipat @@an
menyiratkan	men @@sirat @@kan
norwegia	norwegia
belakangku	belakang @@ku
mempengaruhi	men @@pengaruh @@i
kelapa	kelapa
penuntasan	pen @@tuntas @@an
lereng	lereng
kiri	kiri
antartempat	antar @@tempat
antarpemerintah	antar @@pen @@perintah
diangkut	di @@angkut
diperbesar	di @@per @@besar
mengajarkan	men @@ajar @@kan
mendaftarkannya	men @@daftar @@kan @@nya
mulanya	mula @@nya
terkungkung	ter @@kungkung
bilang	bilang
halaman	halaman
imbangannya	imbang @@an @@nya
kartu	kartu
produk	produk
ungkapkan	ungkap @@kan
lahirnya	lahir @@nya
pbb	pbb
truknya	truk @@nya
diperbuatnya	di @@per @@buat @@nya
pendidikannya	pen @@didik @@an @@nya
alatnya	alat @@nya
kepala	kepala
jabar	jabar
kliring	kliring
tewas	tewas
cakupannya	cakup @@an @@nya
plastiknya	plastik @@nya
mengasumsikan	men @@asumsi @@kan
kutukan	kutuk @@an
tetapnya	tetap @@nya
menghiburnya	men @@hibur @@nya
simpan	simpan
dituntaskan	di @@tuntas @@kan
cobakan	coba @@kan
menyimaknya	men @@simak @@nya
kubu	kubu
peredam	pen @@redam
belenggu	belenggu
pangkal	pangkal
ditepati	di @@tepat @@i
nonmakanan	non @@makan @@an
berkilauan	ber @@kilau @@an
perkara	perkara
zamannya	zaman @@nya
katak	katak
dikhawatirkan	di @@khawatir @@kan
berimplikasi	ber @@implikasi
mematikan	men @@mati @@kan
berniat	ber @@niat
cukai	cuka @@i
sentral	sentral
kendalanya	kendala @@nya
terdekat	ter @@dekat
jatah	jatah
andalan	andal @@an
nondepartemen	non @@departemen
dokumentasi	dokumentasi
ancaman	ancam @@an
militan	militan
asal	asal
ikutannya	ikut @@an @@nya
ingat	ingat
lupa	lupa
buahnya	buah @@nya
konotasi	konotasi
pengerukan	pen @@keruk @@an
terumbu	terumbu
buruan	buru @@an
pempublikasian	pen @@publikasi @@an
sepatu	sepatu
sikat	sikat
ditanam	di @@tanam
karya	karya
menukar	men @@tukar
pencanangan	pen @@canang @@an
merendahkan	men @@rendah @@kan
berbaring	ber @@baring
persahabatan	per @@sahabat @@an
berkompeten	ber @@kompeten
cercaan	cerca @@an
diabaikan	di @@abai @@kan
penekan	pen @@tekan
melumpuhkannya	men @@lumpuh @@kan @@nya
penderita	pen @@derita
ditopang	di @@topang
permainan	per @@main @@an
pengambil	pen @@ambil
palang	palang
ditampilkan	di @@tampil @@kan
berteriak	ber @@teriak
bergegas	ber @@gegas
mengulurkan	men @@ulur @@kan
keliru	keliru
menerjang	men @@terjang
natur	natur
periklanan	per @@iklan @@an
budimu	budi @@mu
subkontraknya	subkontrak @@nya
kokpit	kokpit
selektifnya	selektif @@nya
khawatir	khawatir
berpikirnya	ber @@pikir @@nya
menghafal	men @@hafal
pembeli	pen @@beli
terkelompok	ter @@kelompok
tambang	tambang
bergembira	ber @@gembira
bajakan	bajak @@an
memuji	men @@puji
produksinya	produksi @@nya
dikeraskan	di @@keras @@kan
terbebas	ter @@bebas
percayai	percaya @@i
mengaudit	men @@audit
berkonsultasi	ber @@konsultasi
sudut	sudut
lembar	lembar
pertandingan	per @@tanding @@an
mengenai	men @@kena @@i
tradisionalnya	tradisional @@nya
muhammad	muhammad
khotbah	khotbah
ketidakberanian	ke @@tidak @@berani @@an
beralih	ber @@alih
pelat	pelat
teluk	teluk
detektif	detektif
berkhotbah	ber @@khotbah
ampuh	ampuh
terpahat	ter @@pahat
motornya	motor @@nya
berikut	ber @@ikut
bahasanya	bahasa @@nya
karakteristik	karakteristik
permata	permata
seefektif	se @@efektif
kuabaikan	ku @@abai @@kan
digariskan	di @@garis @@kan
mengenalinya	men @@kenal @@i @@nya
terjangkaunya	ter @@jangkau @@nya
berdiam	ber @@diam
genangan	genang @@an
menjaganya	men @@jaga @@nya
peternakannya	peternakan @@nya
piring	piring
ciptanya	cipta @@nya
saham	saham
tebalnya	tebal @@nya
prakteknya	praktek @@nya
bersaing	ber @@saing
dialokasikan	di @@alokasi @@kan
langganan	langgan @@an
transportasi	transportasi
mengalir	men @@alir
projek	projek
aktifitasnya	aktifitas @@nya
keseharian	keseharian
tukang	tukang
pasif	pasif
dipalsukan	di @@palsu @@kan
doakan	doa @@kan
sekretariat	sekretariat
posisi	posisi
dikutip	di @@kutip
tetes	tetes
lautan	laut @@an
semacam	se @@macam
pengadu	pen @@adu
tebal	tebal
gabungan	gabung @@an
sedia	sedia
mengasuransi	men @@asuransi
merasuk	men @@rasuk
mengefisienkan	men @@efisien @@kan
memonitor	men @@monitor
impor	impor
mengemudikan	men @@kemudi @@kan
purnama	purnama
mengantarnya	men @@antar @@nya
penyampaian	pen @@sampai @@an
pengepakan	pen @@kepak @@an
diakumulasikan	di @@akumulasi @@kan
berkelahi	ber @@kelahi
dibaca	di @@baca
jungkir	jungkir
fasilitatornya	fasilitator @@nya
imigran	imigran
mengubah	men @@ubah
beraib	ber @@aib
pemantauan	pen @@pantau @@an
anda	anda
ular	ular
gejolak	gejolak
tuliskan	tulis @@kan
pembayar	pen @@bayar
membebaskan	men @@bebas @@kan
esok	esok
pendamaian	pen @@damai @@an
lengkung	lengkung
faktor	faktor
memandunya	men @@pandu @@nya
fisika	fisika
memobilisasi	men @@mobilisasi
didesentralisasikan	di @@desentralisasi @@kan
melewati	men @@lewat @@i
mengesahkan	men @@sah @@kan
terperdaya	ter @@perdaya
bos	bos
akunting	akunting
pengangsuran	pen @@angsur @@an
terlarut	ter @@larut
rekaan	reka @@an
mayoritas	mayoritas
penyusun	pen @@susun
tahun	tahun
tenar	tenar
memediasi	men @@mediasi
berotoritas	ber @@otoritas
yakub	yakub
bakan	bak @@an
menganalisis	men @@analisis
lihat	lihat
sehebat	se @@hebat
video	video
unggulannya	unggul @@an @@nya
mengasari	men @@kasar @@i
lambang	lambang
memandu	men @@pandu
menghadang	men @@hadang
hebat	hebat
terjaga	ter @@jaga
pengurusannya	pen @@urus @@an @@nya
susahnya	susah @@nya
memperluas	men @@luas
berhentinya	ber @@henti @@nya
merekatkan	men @@rekat @@kan
beralkohol	ber @@alkohol
menyampaikannya	men @@sampai @@kan @@nya
berselisih	ber @@selisih
mentah	mentah
membagikannya	men @@bagi @@kan @@nya
demam	demam
mendukung	men @@dukung
mengantar	men @@antar
tujuannya	tuju @@an @@nya
diterimanya	di @@terima @@nya
terlantar	terlantar
menyuruh	men @@suruh
susah	susah
jadwalnya	jadwal @@nya
implikasinya	implikasi @@nya
pengetahuan	pengetahuan
serigala	serigala
bertanggung	ber @@tanggung
menyikat	men @@sikat
mendoakannya	men @@doa @@kan @@nya
pangeran	pangeran
pengeluarannya	pen @@keluar @@an @@nya
menyerahkannya	men @@serah @@kan @@nya
dipimpin	di @@pimpin
mendekat	men @@dekat
menyusun	men @@susun
diacuhkan	di @@acuh @@kan
nada	nada
merelokasi	men @@relokasi
mengontak	men @@kontak
penakluk	pen @@takluk
penopang	pen @@topang
maksimal	maksimal
sukarnya	sukar @@nya
bruto	bruto
lemaknya	lemak @@nya
persawahan	per @@sawah @@an
diolesi	di @@oles @@i
tingkatnya	tingkat @@nya
penitipan	pen @@titip @@an
dipanen	di @@panen
bersembunyi	ber @@sembunyi
beraturan	ber @@atur @@an
kisahnya	kisah @@nya
menewaskan	men @@tewas @@kan
lomba	lomba
dideritanya	di @@derita @@nya
pembentuk	pen @@bentuk
dikalahkan	di @@kalah @@kan
biolanya	biola @@nya
menandai	men @@tanda @@i
menginvestasikannya	men @@investasi @@kan @@nya
selangit	se @@langit
ketidakseriusan	ke @@tidak @@serius @@an
pembuatannya	pen @@buat @@an @@nya
dititipkan	di @@titip @@kan
asalan	asal @@an
dimaksudkan	di @@maksud @@kan
dikompilasi	di @@kompilasi
memodernisasi	men @@modernisasi
menggunakannya	men @@guna @@kan @@nya
sambungan	sambung @@an
kakeknya	kakek @@nya
berkolaborasi	ber @@kolaborasi
kubuang	ku @@buang
berbeban	ber @@beban
fokus	fokus
berharap	ber @@harap
inflasi	inflasi
tertuang	ter @@tuang
berlangsungnya	ber @@langsung @@nya
terhalangi	ter @@halang @@i
kadaluarsa	kadaluarsa
menuliskan	men @@tulis @@kan
motor	motor
menyentuhnya	men @@sentuh @@nya
padinya	padi @@nya
tercengang	ter @@cengang
beritakan	berita @@kan
memposisikan	men @@posisi @@kan
terbenamnya	ter @@benam @@nya
jerat	jerat
penalarannya	pen @@nalar @@an @@nya
menggemakan	men @@gema @@kan
kedipan	kedip @@an
mengelabui	men @@kelabui
ditelusuri	di @@telusuri
sintetis	sintetis
menjawab	men @@jawab
sindikat	sindikat
ringkasan	ringkas @@an
mengabulkan	men @@kabul @@kan
mulianya	mulia @@nya
majikan	majikan
dikaruniakan	di @@karunia @@kan
pertalian	per @@tali @@an
komitmennya	komitmen @@nya
seluas	se @@luas
memisahkan	men @@pisah @@kan
kerasnya	keras @@nya
persemaian	per @@semai @@an
diselesaikan	di @@selesai @@kan
terjembatani	ter @@jembatan @@i
berpemerintahan	ber @@pen @@perintah @@an
penghilangan	pen @@hilang @@an
ambruknya	ambruk @@nya
permukaan	per @@muka @@an
pembagian	pen @@bagi @@an
maksudkan	maksud @@kan
berpesta	ber @@pesta
kelamin	kelamin
lerengan	lereng @@an
ditransaksikan	di @@transaksi @@kan
pelayarannya	pen @@layar @@an @@nya
bertumpu	ber @@tumpu
penipu	pen @@tipu
keledai	keledai
dikumandangkan	di @@kumandang @@kan
habis	habis
mengunci	men @@kunci
postingan	posting @@an
diturunkan	di @@turun @@kan
meninggal	men @@tinggal
akhirat	akhirat
mengingatnya	men @@ingat @@nya
tanam	tanam
ketidaktransparanan	ke @@tidak @@transparan @@an
topik	topik
vulkanik	vulkanik
arah	arah
rakyat	rakyat
lemah	lemah
umumnya	umum @@nya
review	review
lumpuh	lumpuh
berair	ber @@air
mendekatinya	men @@dekat @@i @@nya
sekarat	se @@karat
dipersoalkan	di @@per @@soal @@kan
rajaku	raja @@aku
cina	cina
kutuk	kutuk
tergoda	ter @@goda
antarkegiatan	antar @@ke @@giat @@an
ajaran	ajar @@an
berfokus	ber @@fokus
kelanjutannya	ke @@lanjut @@an @@nya
disampaikannya	di @@sampai @@kan @@nya
meluangkan	men @@luang @@kan
menyatakan	men @@nyata @@kan
giat	giat
pegangannya	pegang @@an @@nya
mencontohkan	men @@contoh @@kan
dirumahkan	di @@rumah @@kan
mertua	mertua
sepuasnya	se @@puas @@nya
gelarnya	gelar @@nya
keturunan	ke @@turun @@an
cirinya	ciri @@nya
diputuskan	di @@putus @@kan
menyombongkan	men @@sombong @@kan
hangat	hangat
depkeu	depkeu
senada	se @@nada
tercantum	ter @@cantum
berdana	ber @@dana
meter	meter
perbanyakan	per @@banyak @@an
kepalaku	kepala @@aku
bertambahnya	ber @@tambah @@nya
menegangkan	men @@tegang @@kan
telur	telur
terganggu	ter @@ganggu
menggunung	men @@gunung
antikekerasan	anti @@ke @@keras @@an
diolah	di @@olah
mukamu	muka @@kamu
didampinginya	di @@damping @@i @@nya
ilmiah	ilmiah
terguncang	ter @@guncang
pengendalian	pen @@kendali @@an
persaingan	per @@saing @@an
kelimpahan	ke @@limpah @@an
sabuk	sabuk
komitenya	komite @@nya
bidikan	bidik @@an
pt	pt
hadirat	hadirat
jeratan	jerat @@an
janjinya	janji @@nya
memajang	men @@pajang
pemutusan	pen @@putus @@an
ditunjuk	di @@tunjuk
letaknya	letak @@nya
pemasok	pen @@pasok
pelestarian	pen @@lestari @@an
nonharga	non @@harga
bersalah	ber @@salah
cacat	cacat
melonjak	men @@lonjak
kamera	kamera
bangunan	bangun @@an
menguntungkan	men @@untung @@kan
pertukaran	per @@tukar @@an
adonan	adon @@an
standarisasi	standarisasi
menemani	men @@teman @@i
dikerjasamakan	di @@kerjasama @@kan
pertengkaran	per @@tengkar @@an
ide	ide
penenun	pen @@tenun
mengadakan	men @@ada @@kan
kecolongan	kecolongan
pil	pil
mengatur	men @@atur
bayangkan	bayang @@kan
semapan	se @@mapan
menyelami	men @@selam @@i
lantai	lantai
tepian	tepi @@an
belakangmu	belakang @@mu
pegangan	pegang @@an
mengumandangkan	men @@kumandang @@kan
menghadap	men @@hadap
menyusu	men @@susu
ruh	ruh
operator	operator
berorientasi	ber @@orientasi
membantu	men @@bantu
beracun	ber @@racun
berteduh	ber @@teduh
tinggi	tinggi
operasi	operasi
mencermatinya	men @@cermat @@i @@nya
awak	awak
menghindar	men @@hindar
dianutnya	di @@anut @@nya
pengupahan	pen @@upah @@an
pelabuhan	pen @@labuh @@an
dasarnya	dasar @@nya
pengarung	pen @@karung
pengekspor	pen @@ekspor
pengeras	pen @@keras
perzinaan	per @@zina @@an
ramainya	ramai @@nya
rapat	rapat
menghilangkannya	men @@hilang @@kan @@nya
santapan	santap @@an
telaknya	telak @@nya
populer	populer
ketetapan	ke @@tetap @@an
bergulir	ber @@gulir
pikun	pikun
bercanda	ber @@canda
bersifat	ber @@sifat
detak	detak
profesionalisme	profesionalisme
berlebihan	ber @@lebih @@an
menjerit	men @@jerit
pipi	pipi
mencair	men @@cair
utama	utama
karyawannya	karya @@wan @@nya
memikulmu	men @@pikul @@mu
ruangnya	ruang @@nya
mengambil	men @@ambil
menopang	men @@topang
warganegara	warganegara
keramik	keramik
donasi	donasi
intensif	intensif
didesain	di @@desain
timbul	timbul
penundaan	pen @@tunda @@an
mengalokasi	men @@alokasi
minum	minum
kusampaikan	ku @@sampai @@kan
penyembuhan	pen @@sembuh @@an
menggelitik	men @@gelitik
diungkapkan	di @@ungkap @@kan
bala	bala
upahnya	upah @@nya
menyarankan	men @@saran @@kan
penerimaannya	pen @@terima @@an @@nya
krisis	krisis
ditutup	di @@tutup
disempurnakan	di @@sempurna @@kan
memberdayakan	men @@ber @@daya @@kan
berantai	ber @@rantai
dipetik	di @@petik
penasehat	pen @@nasehat
antri	antri
singa	singa
memeriksanya	men @@periksa @@nya
ketidakstabilan	ke @@tidak @@stabil @@an
seksual	seksual
anu	anu
liriknya	lirik @@nya
selatan	selatan
konstan	konstan
sesama	se @@sama
dll	dll
besi	besi
logo	logo
serangga	serangga
datar	datar
meminjamnya	men @@pinjam @@nya
islami	islam @@i
memasang	men @@pasang
menarifkan	men @@tarif @@kan
lingkup	lingkup
dipertegas	di @@per @@tegas
dilemahkan	di @@lemah @@kan
pengaksesan	pen @@akses @@an
konservasi	konservasi
mengeluhkan	men @@keluh @@kan
melembaga	men @@lembaga
ditakuti	di @@takut @@i
perintah	perintah
kristus	kristus
melacak	men @@lacak
harumnya	harum @@nya
berakal	ber @@akal
kenalan	kenal @@an
lemahnya	lemah @@nya
ngomongnya	ngomong @@nya
unik	unik
partikel	partikel
mainanmu	main @@an @@mu
tulus	tulus
modern	modern
memprakirakan	men @@prakira @@kan
korban	korban
mengingat	men @@ingat
proyek	proyek
antusias	antusias
menyeluruh	menyeluruh
pemerasan	pen @@peras @@an
berseru	ber @@seru
ketua	ketua
gading	gading
garam	garam
merespons	men @@respons
percetakan	per @@cetak @@an
terasing	ter @@asing
buta	buta
kuajarkan	ku @@ajar @@kan
desentralisasi	desentralisasi
sejalan	se @@jalan
divalidasi	di @@validasi
operatornya	operator @@nya
rambut	rambut
otonomi	otonomi
karir	karir
disadarkan	di @@sadar @@kan
sekeliling	se @@keliling
menyanyi	men @@nyanyi
tebusannya	tebus @@an @@nya
pemuatan	pen @@muat @@an
dimonitor	di @@monitor
luasan	luas @@an
pemodal	pen @@modal
perguruan	per @@guru @@an
penguatan	pen @@kuat @@an
diseberangi	di @@seberang @@i
ambilkan	ambil @@kan
payahmu	payah @@mu
wewenangnya	wewenang @@nya
memodifikasi	men @@modifikasi
raih	raih
permusuhan	per @@musuh @@an
gosip	gosip
pembukaan	pen @@buka @@an
santai	santai
orangtuanya	orangtua @@nya
memperbaikinya	men @@baik @@i @@nya
pelemparan	pen @@lempar @@an
bilangan	bilang @@an
segar	segar
keikutsertaannya	ke @@ikutserta @@an @@nya
memperhadapkan	men @@hadap @@kan
mendampinginya	men @@damping @@i @@nya
variasi	variasi
relokasi	relokasi
keperluan	ke @@perlu @@an
turunkan	turun @@kan
memuncak	men @@puncak
menjenguk	men @@jenguk
masuknya	masuk @@nya
pengumpulan	pen @@kumpul @@an
etis	etis
madunya	madu @@nya
perakitan	pen @@rakit @@an
dihakimi	di @@hakim @@i
baik	baik
putranya	putra @@nya
usang	usang
direpotkan	di @@repot @@kan
dibuat	di @@buat
berbentuk	ber @@bentuk
besoknya	besok @@nya
penjahitan	pen @@jahit @@an
dilibatkan	di @@libat @@kan
infrastruktur	infrastruktur
pasien	pasien
tuntutan	tuntut @@an
bergema	ber @@gema
omzet	omzet
omzetnya	omzet @@nya
obyek	obyek
menerangkan	men @@terang @@kan
politikus	politikus
tali	tali
hadapanku	hadap @@an @@ku
diperoleh	di @@peroleh
meremajakannya	men @@remaja @@kan @@nya
semburan	sembur @@an
bisbol	bisbol
spesial	spesial
simpulkan	simpul @@kan
bertambah	ber @@tambah
dielakkan	di @@elak @@kan
melupakanku	men @@lupa @@kan @@ku
dimasukinya	di @@masuk @@i @@nya
stratanya	strata @@nya
terpilih	ter @@pilih
wisma	wisma
memangkas	men @@pangkas
pendangkalan	pen @@dangkal @@an
halangan	halang @@an
ketidakpahaman	ke @@tidak @@paham @@an
taurat	taurat
jelas	jelas
mengenang	men @@kenang
memasukkan	men @@masuk @@kan
capaian	capai @@an
mampukan	mampu @@kan
harian	hari @@an
lantang	lantang
memukau	men @@pukau
memanjang	men @@panjang
berintegritas	ber @@integritas
pemenang	pen @@menang
kandungan	kandung @@an
pertumbuhannya	per @@tumbuh @@an @@nya
sejenisnya	se @@jenis @@nya
ditukar	di @@tukar
sendirinya	sendiri @@nya
pedihnya	pedih @@nya
ijon	ijon
waktuku	waktu @@ku
memiliki	men @@milik @@i
persis	persis
seleksi	seleksi
dicetak	di @@cetak
berterimakasih	ber @@terimakasih
tebus	tebus
diterus	di @@terus
remajanya	remaja @@nya
program	program
wakil	wakil
antarindustri	antar @@industri
berselang	ber @@selang
ingatan	ingat @@an
putusan	putus @@an
diperlebar	di @@per @@lebar
napas	napas
tuaku	tua @@aku
besok	besok
sibuknya	sibuk @@nya
mengasah	men @@asah
kritik	kritik
melibatkan	men @@libat @@kan
darah	darah
sorot	sorot
desanya	desa @@nya
mendampingi	men @@damping @@i
kayu	kayu
sejawatnya	se @@jawat @@nya
kabel	kabel
mogok	mogok
peringkat	peringkat
garis	garis
berdinding	ber @@dinding
dieliminasi	di @@eliminasi
klasiknya	klasik @@nya
silakan	silakan
olokan	olok @@an
ilmu	ilmu
kakinya	kaki @@nya
bilik	bilik
memperingati	men @@ingat @@i
ditugaskan	di @@tugas @@kan
tongkat	tongkat
membakarmu	men @@bakar @@mu
menebusnya	men @@tebus @@nya
dokumenter	dokumenter
memberkati	men @@berkat @@i
nonpertanian	non @@per @@tani @@an
antarresponden	antar @@responden
mengadukan	men @@adu @@kan
berdasar	ber @@dasar
bata	bata
terdidik	ter @@didik
juang	juang
almamaternya	almamater @@nya
adu	adu
perut	perut
kantor	kantor
pelecehan	pen @@leceh @@an
tarifnya	tarif @@nya
seikhlasnya	se @@ikhlas @@nya
perlindungan	per @@lindung @@an
penciptaan	pen @@cipta @@an
triwulanan	triwulan @@an
persekutuan	per @@sekutu @@an
diminta	di @@minta
mewawancarai	men @@wawancara @@i
sejahtera	sejahtera
nuraninya	nurani @@nya
citra	citra
berambut	ber @@rambut
menyesatkan	men @@sesat @@kan
sejelas	se @@jelas
sejarah	sejarah
bersengketa	ber @@sengketa
kubur	kubur
menanggulanginya	men @@tanggulang @@i @@nya
tiang	tiang
mengawasi	men @@awas @@i
menonjolkan	men @@tonjol @@kan
prosedural	prosedural
parfum	parfum
januari	januari
berhembus	ber @@hembus
pengepungan	pen @@kepung @@an
melimpahkan	men @@limpah @@kan
pesawat	pesawat
keinginanmu	ke @@ingin @@an @@mu
berjabat	ber @@jabat
menanggungnya	men @@tanggung @@nya
dilatihnya	di @@latih @@nya
menghargainya	men @@harga @@i @@nya
paman	paman
inovasi	inovasi
aib	aib
bertatap	ber @@tatap
berserah	ber @@serah
dikatakannya	di @@kata @@kan @@nya
senjata	senjata
ketinggalan	ke @@tinggal @@an
isteri	isteri
siswanya	siswa @@nya
menggerebek	men @@gerebek
dipinjami	di @@pinjam @@i
prospek	prospek
repotnya	repot @@nya
menuding	men @@tuding
penyebarannya	pen @@sebar @@an @@nya
terjemahan	terjemah @@an
ludah	ludah
dilihatnya	di @@lihat @@nya
max	max
tiket	tiket
digigit	di @@gigit
jadwalku	jadwal @@ku
mengobarkan	men @@kobar @@kan
menggagas	men @@gagas
akal	akal
penghambat	pen @@hambat
asas	asas
pegolf	pen @@golf
didominasi	di @@dominasi
ironis	ironis
mengimbangi	men @@imbang @@i
berenang	ber @@renang
setuju	setuju
didampingi	di @@damping @@i
termiskin	ter @@miskin
buruannya	buru @@an @@nya
sebangsaku	se @@bangsa @@aku
tenggelam	tenggelam
membawahi	men @@bawah @@i
taman	taman
istana	istana
berada	ber @@ada
nasibnya	nasib @@nya
desa	desa
berpaling	ber @@paling
ketahui	ketahui
sederhana	sederhana
beranggotakan	ber @@anggota @@kan
menebus	men @@tebus
pergulatan	per @@gulat @@an
berkoordinasi	ber @@koordinasi
sabet	sabet
keterampilannya	keterampilan @@nya
relasi	relasi
anggarannya	anggar @@an @@nya
pemboman	pen @@bom @@an
dangkal	dangkal
antik	antik
nyeri	nyeri
katanya	kata @@nya
mengambilkan	men @@ambil @@kan
kehendaki	kehendak @@i
penambahan	pen @@tambah @@an
pacarku	pacar @@ku
gilirannya	gilir @@an @@nya
tambak	tambak
menguras	men @@kuras
gelisah	gelisah
belakangnya	belakang @@nya
sepeda	sepeda
makanan	makan @@an
keharusan	ke @@harus @@an
balistik	balistik
bergiliran	ber @@gilir @@an
semacamnya	se @@macam @@nya
jurnalisme	jurnalisme
gelar	gelar
warung	warung
memberikan	men @@beri @@kan
karirnya	karir @@nya
naskah	naskah
menduga	men @@duga
pelindungnya	pen @@lindung @@nya
mencabutnya	men @@cabut @@nya
membusukkan	men @@busuk @@kan
pengelolanya	pen @@kelola @@nya
sulit	sulit
menggarisbawahi	men @@garisbawah @@i
dilatih	di @@latih
latarbelakang	latarbelakang
memproduksi	men @@produksi
dolar	dolar
menghalangi	men @@halang @@i
diraih	di @@raih
pujian	puji @@an
petunjuknya	petunjuk @@nya
lilin	lilin
umat	umat
filosofi	filosofi
batinnya	batin @@nya
kemukakan	kemuka @@kan
kriminal	kriminal
segmen	segmen
keberadaan	keberadaan
menghiraukan	men @@hirau @@kan
penyerahan	pen @@serah @@an
terbelakang	ter @@belakang
signifikan	signifikan
demokratis	demokratis
usahakan	usaha @@kan
perhitungannya	per @@hitung @@an @@nya
usulan	usul @@an
kompetitif	kompetitif
kemunculannya	ke @@muncul @@an @@nya
dikontrak	di @@kontrak
yupiter	yupiter
dibuang	di @@buang
terdesentralisasi	ter @@desentralisasi
diperburuk	di @@per @@buruk
pengikutnya	pen @@ikut @@nya
pencerahan	pen @@cerah @@an
kontraktornya	kontraktor @@nya
ayatnya	ayat @@nya
musiman	musim @@an
pengantarnya	pen @@antar @@nya
sholat	sholat
terlembagakan	ter @@lembaga @@kan
balap	balap
kesehariannya	keseharian @@nya
cokelat	cokelat
gelandang	gelandang
dihadapinya	di @@hadap @@i @@nya
ditaburkan	di @@tabur @@kan
menuduhnya	men @@tuduh @@nya
pelikan	pelik @@an
porsi	porsi
piringan	piring @@an
mamalia	mamalia
kota	kota
terjepit	ter @@jepit
menyekolahkan	men @@sekolah @@kan
dikepalai	di @@kepala @@i
isolasi	isolasi
membimbing	men @@bimbing
berdagang	ber @@dagang
universitas	universitas
mendapati	men @@dapat @@i
bertepuk	ber @@tepuk
perusahaannya	per @@usaha @@an @@nya
golongan	golong @@an
mulus	mulus
disepakati	di @@sepakat @@i
merawatnya	men @@rawat @@nya
penerbangannya	pen @@terbang @@an @@nya
turun	turun
memasarkannya	men @@pasar @@kan @@nya
dijejali	di @@jejal @@i
besarannya	besar @@an @@nya
diproses	di @@proses
dirampok	di @@rampok
antrian	antri @@an
dicegat	di @@cegat
dijemput	di @@jemput
berduka	ber @@duka
dimapankan	di @@mapan @@kan
kentang	kentang
ganti	ganti
terdapat	ter @@dapat
meraih	men @@raih
diikutkan	di @@ikut @@kan
diterjang	di @@terjang
pendamping	pen @@damping
putaran	putar @@an
diwarisi	di @@waris @@i
antarrumah	antar @@rumah
janda	janda
maksudnya	maksud @@nya
kaidah	kaidah
gemar	gemar
pencarian	pen @@cari @@an
pergumulannya	per @@gumul @@an @@nya
cincin	cincin
pengadilan	pen @@adil @@an
serumit	se @@rumit
jatuh	jatuh
beresiko	ber @@resiko
teriak	teriak
penyalahgunaan	pen @@salahguna @@an
berpelukan	ber @@peluk @@an
menghindarkan	men @@hindar @@kan
mengadili	men @@adil @@i
semaksimal	se @@maksimal
relawan	rela @@wan
didambakannya	di @@damba @@kan @@nya
bertransaksi	ber @@transaksi
terkepung	ter @@kepung
rubuh	rubuh
mencurangi	men @@curang @@i
diingat	di @@ingat
kalkun	kalkun
menghadapinya	men @@hadap @@i @@nya
diawali	di @@awal @@i
diserang	di @@serang
dewan	dewan
liat	liat
menimpanya	men @@timpa @@nya
duduk	duduk
ketidaksetujuan	ke @@tidak @@setuju @@an
satker	satker
hartanya	harta @@nya
terucap	ter @@ucap
tempuran	tempur @@an
menyetir	men @@setir
lambatnya	lambat @@nya
ketidaksesuaian	ke @@tidak @@sesuai @@an
eternit	eternit
diluruskan	di @@lurus @@kan
ngeri	ngeri
mengoyakkan	men @@koyak @@kan
jiwamu	jiwa @@mu
miskin	miskin
berarti	ber @@arti
mengecilkan	men @@kecil @@kan
bi	bi
identik	identik
dinding	dinding
ditangani	di @@tangan @@i
ceritakan	cerita @@kan
terjadinya	ter @@jadi @@nya
pakan	pakan
objek	objek
menyalami	men @@salam @@i
menjunjung	men @@junjung
pemangkasan	pen @@pangkas @@an
memikul	men @@pikul
gembalakan	gembala @@kan
tentaranya	tentara @@nya
dimainkan	di @@main @@kan
tangerang	tangerang
serang	serang
penggaris	pen @@garis
digandakan	di @@ganda @@kan
jantungnya	jantung @@nya
ditambahkannya	di @@tambah @@kan @@nya
perspektif	perspektif
mekanik	mekanik
adakan	ada @@kan
matematika	matematika
berliku	ber @@liku
1990an	1990 @@an
susun	susun
iklannya	iklan @@nya
nyatakan	nyata @@kan
dicurahkan	di @@curah @@kan
melandasi	men @@landas @@i
mengelola	men @@kelola
nonaset	non @@aset
visi	visi
iklim	iklim
disamai	di @@sama @@i
menyasar	men @@sasar
antarstatus	antar @@status
juri	juri
pengantin	pengantin
rencana	rencana
perluasan	per @@luas @@an
dipanggil	di @@panggil
dicurahkannya	di @@curah @@kan @@nya
bahas	bahas
deskripsi	deskripsi
tindihnya	tindih @@nya
jenderal	jenderal
disesuaikan	di @@sesuai @@kan
dikoordinir	di @@koordinir
mendesentralisasikan	men @@desentralisasi @@kan
damai	damai
memulihkan	men @@pulih @@kan
status	status
komisi	komisi
perdagangannya	per @@dagang @@an @@nya
landas	landas
menggosokkan	men @@gosok @@kan
mendokumentasikan	men @@dokumentasi @@kan
dihormati	di @@hormat @@i
binaan	bina @@an
kabarkan	kabar @@kan
padang	padang
tampung	tampung
ditaruhnya	di @@taruh @@nya
memuaskan	men @@puas @@kan
malam	malam
yunus	yunus
dosa	dosa
budaya	budaya
menggemukkannya	men @@gemuk @@kan @@nya
tergantung	ter @@gantung
anemia	anemia
rusak	rusak
muncul	muncul
melodi	melodi
pemungutan	pen @@pungut @@an
mengucap	men @@ucap
berlumur	ber @@lumur
ayat	ayat
anekdot	anekdot
analisisnya	analisis @@nya
menjiwai	men @@jiwa @@i
mengulas	men @@ulas
pelabuhannya	pen @@labuh @@an @@nya
pikul	pikul
bersamanya	ber @@sama @@nya
pinggir	pinggir
pemilihannya	pen @@pilih @@an @@nya
ladang	ladang
perkantoran	per @@kantor @@an
atap	atap
berlaga	ber @@laga
evaluasi	evaluasi
menuntutnya	men @@tuntut @@nya
ketidakpedulian	ke @@tidak @@peduli @@an
ban	ban
titipan	titip @@an
mempergunakan	men @@guna @@kan
meksiko	meksiko
ambang	ambang
mencadangkan	men @@cadang @@kan
beririgasi	ber @@irigasi
pelunasan	pen @@lunas @@an
evakuasi	evakuasi
mungilnya	mungil @@nya
longsor	longsor
institusinya	institusi @@nya
diproduksi	di @@produksi
mengklarifikasi	men @@klarifikasi
pengguna	pen @@guna
sertifikatnya	sertifikat @@nya
cemas	cemas
bergelut	ber @@gelut
sifat	sifat
dadanya	dada @@nya
baiknya	baik @@nya
lingkungannya	lingkung @@an @@nya
serakah	serakah
tanda	tanda
antarpengadilan	antar @@pen @@adil @@an
derita	derita
dipegang	di @@pegang
individu	individu
penyiar	pen @@siar
athena	athena
diteruskan	di @@terus @@kan
bantalan	bantal @@an
pengembalian	pen @@kembali @@an
membasahi	men @@basah @@i
berkabung	berkabung
toleransi	toleransi
diadopsi	di @@adopsi
berwujud	ber @@wujud
memukuli	men @@pukul @@i
kambing	kambing
pengangkut	pen @@angkut
menggantungkan	men @@gantung @@kan
pemberdayaan	pemberdayaan
didasari	di @@dasar @@i
prosedurnya	prosedur @@nya
egois	egois
dipatuhi	di @@patuh @@i
aneh	aneh
dipadukan	di @@padu @@kan
menambahkan	men @@tambah @@kan
dipulau	di @@pulau
penjamin	pen @@jamin
nikel	nikel
terwujud	ter @@wujud
diasah	di @@asah
mengestimasi	men @@estimasi
menyebarkan	men @@sebar @@kan
sedunia	se @@dunia
bergunung	ber @@gunung
kirinya	kiri @@nya
menunda	men @@tunda
menggeluti	men @@gelut @@i
terbang	terbang
saus	saus
kotamadya	kotamadya
kutinggalkan	ku @@tinggal @@kan
merambah	men @@rambah
kalkulasi	kalkulasi
bergeser	ber @@geser
mutlak	mutlak
lini	lini
melanggar	men @@langgar
waktunya	waktu @@nya
penyebabnya	pen @@sebab @@nya
dijaga	di @@jaga
meninjau	men @@tinjau
disangkal	di @@sangkal
diawasi	di @@awas @@i
diujicobakan	di @@ujicoba @@kan
uu	uu
mencipratkan	men @@ciprat @@kan
direkrut	di @@rekrut
fokusnya	fokus @@nya
mulia	mulia
jiwa	jiwa
riil	riil
rekreasi	rekreasi
minggunya	minggu @@nya
terakhirnya	ter @@akhir @@nya
nyanyian	nyanyi @@an
enaknya	enak @@nya
menggunting	men @@gunting
melecehkan	men @@leceh @@kan
mengkonsolidasikan	men @@konsolidasi @@kan
membangkitkanku	men @@bangkit @@kan @@ku
perjuangannya	per @@juang @@an @@nya
merakit	men @@rakit
usianya	usia @@nya
bergaul	ber @@gaul
menyerahkan	men @@serah @@kan
ternak	ternak
pemanfaatan	pen @@manfaat @@an
perimbangan	per @@imbang @@an
pembicara	pen @@bicara
alamiah	alamiah
pertukangan	per @@tukang @@an
bulunya	bulu @@nya
bersukacita	ber @@sukacita
menuntunnya	men @@tuntun @@nya
memverifikasi	men @@verifikasi
ajakan	ajak @@an
roti	roti
dicoba	di @@coba
musiknya	musik @@nya
mengharapkan	men @@harap @@kan
berkeluarga	ber @@keluarga
dijabarkan	di @@jabar @@kan
renang	renang
mengherankan	men @@heran @@kan
kancing	kancing
penggenapannya	pen @@genap @@an @@nya
berpakaian	ber @@pakai @@an
anehnya	aneh @@nya
literatur	literatur
allahnya	allah @@nya
kuhadapi	ku @@hadap @@i
hancur	hancur
melaluinya	men @@lalu @@i @@nya
dewa	dewa
pulangnya	pulang @@nya
akses	akses
sungai	sungai
koran	koran
ajuan	aju @@an
angkanya	angka @@nya
konversi	konversi
pembebanan	pen @@beban @@an
menumbuhkan	men @@tumbuh @@kan
peletakan	pen @@letak @@an
menyusut	men @@susut
bermoral	ber @@moral
kupas	kupas
mengungkapkan	men @@ungkap @@kan
hibur	hibur
penggemukan	pen @@gemuk @@an
bernaung	ber @@naung
dilema	dilema
forensik	forensik
nikah	nikah
dikonfirmasikan	di @@konfirmasi @@kan
antarkabupaten	antar @@kabupaten
mengelompok	men @@kelompok
kirim	kirim
likuiditas	likuiditas
berputus	ber @@putus
penanam	pen @@tanam
berteman	ber @@teman
konsekuensi	konsekuensi
serok	se @@rok
dipromosikan	di @@promosi @@kan
putra	putra
berotak	ber @@otak
masjid	masjid
terdata	ter @@data
ketidaknyamanan	ke @@tidak @@nyaman @@an
terancam	ter @@ancam
mimpi	mimpi
independensinya	independensi @@nya
ditolak	di @@tolak
mengkhianati	men @@khianat @@i
dimodifikasi	di @@modifikasi
teh	teh
diaudit	di @@audit
dipertimbangkan	di @@per @@timbang @@kan
ajalnya	ajal @@nya
diwawancara	di @@wawancara
bagus	bagus
penegak	pen @@tegak
membayang	men @@bayang
dimuat	di @@muat
intelektual	intelektual
umpan	umpan
direstrukturisasi	di @@restrukturisasi
menganggapnya	men @@anggap @@nya
dihadapi	di @@hadap @@i
izin	izin
mengijonkan	men @@ijon @@kan
sebulir	se @@bulir
disisihkan	di @@sisih @@kan
terpaksa	ter @@paksa
merepresentasi	men @@representasi
capnya	cap @@nya
cipta	cipta
diulangi	di @@ulang @@i
terdesak	ter @@desak
panduan	pandu @@an
menghasilkan	men @@hasil @@kan
kepercayaannya	ke @@percaya @@an @@nya
mewawancarainya	men @@wawancara @@i @@nya
alur	alur
memperlihatkan	men @@lihat @@kan
pelayananku	pen @@layan @@an @@ku
suram	suram
persentasenya	persentase @@nya
syiah	syiah
merogoh	men @@rogoh
juruselamat	juruselamat
beranggaran	ber @@anggar @@an
jajaran	jajar @@an
ayub	ayub
dilempar	di @@lempar
depkes	depkes
realitas	realitas
peroleh	peroleh
disesatkan	di @@sesat @@kan
pungli	pungli
perpajakan	per @@pajak @@an
norma	norma
disimpan	di @@simpan
studinya	studi @@nya
penanggungjawab	pen @@tanggungjawab
cita	cita
aduk	aduk
salju	salju
petani	petani
lobi	lobi
kunjung	kunjung
dikontraknya	di @@kontrak @@nya
kembali	kembali
kotoran	kotor @@an
mengetuk	men @@ketuk
praktiknya	praktik @@nya
berasaskan	ber @@asas @@kan
kuterima	ku @@terima
tersebar	ter @@sebar
nama	nama
menonjol	men @@tonjol
penuaan	pen @@tua @@an
terluas	ter @@luas
mengorganisasi	men @@organisasi
terurai	ter @@urai
pembangkit	pen @@bangkit
berupa	ber @@rupa
memburu	men @@buru
diinstruksikan	di @@instruksi @@kan
tamak	tamak
kafir	kafir
nafsu	nafsu
berangsur	ber @@angsur
prinsip	prinsip
panci	panci
didirikannya	di @@diri @@kan @@nya
pencuri	pen @@curi
pasar	pasar
pers	pers
yakin	yakin
reguler	reguler
beliau	beliau
dimerdekakan	di @@merdeka @@kan
depresiasi	depresiasi
penunggak	pen @@tunggak
dituju	di @@tuju
perjamuan	per @@jamu @@an
musim	musim
membobol	men @@bobol
hidung	hidung
mengantisipasi	men @@antisipasi
almamater	almamater
ketahanan	ke @@tahan @@an
ajak	ajak
tambahkan	tambah @@kan
kekasih	kekasih
tanahnya	tanah @@nya
penetapannya	pen @@tetap @@an @@nya
penuntun	pen @@tuntun
rumahan	rumah @@an
superior	superior
mandat	mandat
meninggalnya	men @@tinggal @@nya
berperang	ber @@perang
tetangga	tetangga
logika	logika
direformasi	di @@reformasi
diperiksa	di @@periksa
melimpah	men @@limpah
label	label
tampaknya	tampak @@nya
ajarannya	ajar @@an @@nya
diperingkat	di @@peringkat
menghentikan	men @@henti @@kan
kepemimpinan	kepemimpinan
panjangnya	panjang @@nya
menghabiskannya	men @@habis @@kan @@nya
bima	bima
hilangkan	hilang @@kan
penggantiannya	pen @@ganti @@an @@nya
gunakan	guna @@kan
mengintensifkan	men @@intensif @@kan
pelayanan	pen @@layan @@an
dikehendaki	di @@kehendak @@i
sentuhan	sentuh @@an
memperpanjang	men @@panjang
sutera	sutera
bersabda	ber @@sabda
berlumpur	ber @@lumpur
tercepat	ter @@cepat
psikologis	psikologis
grosir	grosir
geografis	geografis
menyerap	men @@serap
berendam	ber @@rendam
diam	diam
asramanya	asrama @@nya
promosi	promosi
digerakkan	di @@gerak @@kan
uang	uang
pasarnya	pasar @@nya
area	area
menyediakan	men @@sedia @@kan
rinciannya	rinci @@an @@nya
diindikasikan	di @@indikasi @@kan
digolongkan	di @@golong @@kan
berobatnya	ber @@obat @@nya
darussalam	darussalam
kondisinya	kondisi @@nya
berbasiskan	ber @@basis @@kan
digunakannya	di @@guna @@kan @@nya
berpartisipasi	ber @@partisipasi
mengakali	men @@akal @@i
memasukkannya	men @@masuk @@kan @@nya
duka	duka
ketidakkonsistenan	ke @@tidak @@konsisten @@an
rapi	rapi
majalah	majalah
memprihatinkan	men @@prihatin @@kan
pintu	pintu
bertumbuhnya	ber @@tumbuh @@nya
diverifikasi	di @@verifikasi
batalkan	batal @@kan
terpenuhi	men @@penuh @@i
tangisan	tangis @@an
aman	aman
dialirkan	di @@alir @@kan
isapan	isap @@an
sambutan	sambut @@an
membetulkan	men @@betul @@kan
kualitas	kualitas
dibengkokkan	di @@bengkok @@kan
ratap	ratap
panggang	panggang
penempelan	pen @@tempel @@an
menjelajahi	men @@jelajah @@i
penyeludup	pen @@seludup
badannya	badan @@nya
diperantarai	di @@perantara @@i
pandu	pandu
panglima	panglima
menjumpai	men @@jumpa @@i
mengira	men @@kira
mencabuti	men @@cabut @@i
ditendang	di @@tendang
dilucuti	di @@lucut @@i
menambang	men @@tambang
menyokong	men @@sokong
salinan	salin @@an
antiseparatis	anti @@separatis
dilampirkan	di @@lampir @@kan
membina	men @@bina
menyamai	men @@sama @@i
dimuliakan	di @@mulia @@kan
lama	lama
membacanya	men @@baca @@nya
sukunya	suku @@nya
pengusaha	pen @@usaha
berpasir	ber @@pasir
penelitiannya	pen @@teliti @@an @@nya
menghitung	men @@hitung
jepang	jepang
pelanggannya	pen @@langgan @@nya
bergengsi	ber @@gengsi
dilindungi	di @@lindung @@i
ekstra	ekstra
pelayan	pen @@layan
diusung	di @@usung
rindukan	rindu @@kan
rudal	rudal
lanjuti	lanjut @@i
penonton	pen @@tonton
neraca	neraca
bermimpi	ber @@mimpi
diulas	di @@ulas
kebutuhan	ke @@butuh @@an
menggelikan	men @@geli @@kan
bertujuan	ber @@tuju @@an
mengkritik	men @@kritik
catatan	catat @@an
penundukan	pen @@tunduk @@an
peminatnya	pen @@minat @@nya
muliakan	mulia @@kan
membasuh	men @@basuh
memukul	men @@pukul
misterius	misterius
memajukan	men @@maju @@kan
pelihara	pelihara
pulau	pulau
pengangkutan	pen @@angkut @@an
tertata	ter @@tata
menusuk	men @@tusuk
resep	resep
segi	segi
pegunungan	pegunungan
perhatianku	per @@hati @@an @@ku
sampahnya	sampah @@nya
perikanan	per @@ikan @@an
nampak	nampak
dasawarsa	dasawarsa
semangatnya	semangat @@nya
penggorengan	pen @@goreng @@an
disita	di @@sita
penebangan	pen @@tebang @@an
terbentuk	ter @@bentuk
dileskan	di @@les @@kan
guru	guru
memekakkan	men @@pekak @@kan
menegakkan	men @@tegak @@kan
santrinya	santri @@nya
terserang	ter @@serang
mencabut	men @@cabut
mencocokkan	men @@cocok @@kan
ditanya	di @@tanya
setingkat	se @@tingkat
iris	iris
sesuatu	sesuatu
pindah	pindah
padat	padat
antardesa	antar @@desa
mengunyah	men @@kunyah
rintangannya	rintang @@an @@nya
teritorial	teritorial
menanam	men @@tanam
enumerasinya	enumerasi @@nya
bakar	bakar
bajaknya	bajak @@nya
pendistribusian	pen @@distribusi @@an
tertutupi	ter @@tutup @@i
berperan	ber @@peran
pemasangan	pen @@pasang @@an
mengukuhkan	men @@kukuh @@kan
alamat	alamat
mengkredit	men @@kredit
mengikisnya	men @@kikis @@nya
gitarnya	gitar @@nya
penyebab	pen @@sebab
dibiayai	di @@biaya @@i
olahraganya	olahraga @@nya
penghentian	pen @@henti @@an
pantai	pantai
dilumpuhkan	di @@lumpuh @@kan
mengeksploitasi	men @@eksploitasi
revisi	revisi
puding	puding
menafsirkan	men @@tafsir @@kan
ukraina	ukraina
terjal	terjal
berharga	ber @@harga
pemilikan	pen @@milik @@an
permasalahan	per @@masalah @@an
disalin	di @@salin
bidannya	bidan @@nya
berdampingan	ber @@damping @@an
judul	judul
merenung	men @@renung
proporsi	proporsi
penentuan	pen @@tentu @@an
melemparinya	men @@lempar @@i @@nya
pribadinya	pribadi @@nya
menantu	menantu
penegakan	pen @@tegak @@an
orbit	orbit
jawabku	jawab @@ku
berguna	ber @@guna
berdiskusi	ber @@diskusi
sabda	sabda
berintensitas	ber @@intensitas
ujung	ujung
kuatnya	kuat @@nya
berkuda	ber @@kuda
termasuk	ter @@masuk
menatap	men @@tatap
pasukannya	pasukan @@nya
konsentrasi	konsentrasi
ditata	di @@tata
menjelaskan	men @@jelas @@kan
diperkenankan	di @@per @@kenan @@kan
merotasi	men @@rotasi
koleksinya	koleksi @@nya
bakso	bakso
memantaunya	men @@pantau @@nya
menjahit	men @@jahit
anjlok	anjlok
diakui	di @@aku @@i
penyehatan	pen @@sehat @@an
antarlingkungan	antar @@lingkung @@an
departemen	departemen
fluktuasi	fluktuasi
surabaya	surabaya
maksimum	maksimum
dicapai	di @@capai
dukun	dukun
pendampingan	pen @@damping @@an
barang	barang
lurah	lurah
pangkuannya	pangku @@an @@nya
kalah	kalah
karunnya	karun @@nya
penjelajah	pen @@jelajah
transplantasi	transplantasi
ketidakikutsertaan	ke @@tidak @@ikutserta @@an
bersahabat	ber @@sahabat
terekam	ter @@rekam
terakreditasi	ter @@akreditasi
sepenting	se @@penting
sesamaku	se @@sama @@aku
ibadah	ibadah
sains	sains
pengenalanmu	pen @@kenal @@an @@mu
seberat	se @@berat
dilewati	di @@lewat @@i
lapangan	lapang @@an
penipuan	pen @@tipu @@an
menikahi	men @@nikah @@i
teladanku	teladan @@ku
mendiskusikan	men @@diskusi @@kan
kontrakan	kontrak @@an
adegan	adegan
afiliasi	afiliasi
berpagar	ber @@pagar
gubernur	gubernur
pasang	pasang
lanjutannya	lanjut @@an @@nya
parahnya	parah @@nya
terkasih	ter @@kasih
saraf	saraf
perjudian	per @@judi @@an
dinamakan	di @@nama @@kan
sekantung	se @@kantung
hitungan	hitung @@an
sebisa	se @@bisa
dilekatkan	di @@lekat @@kan
klien	klien
dampingannya	damping @@an @@nya
diajak	di @@ajak
dicarikan	di @@cari @@kan
menilik	men @@tilik
campuran	campur @@an
tempatmu	tempat @@mu
menggumamkan	men @@gumam @@kan
teraniaya	ter @@aniaya
dikesampingkan	di @@kesamping @@kan
periode	periode
bir	bir
menggoyahkan	men @@goyah @@kan
fasilitasnya	fasilitas @@nya
birokrasi	birokrasi
memperingatkan	men @@ingat @@kan
menyebut	men @@sebut
menaatinya	men @@taat @@i @@nya
terpencil	terpencil
balita	balita
mentalitas	mentalitas
karakternya	karakteri @@nya
penekanannya	pen @@tekan @@an @@nya
lagu	lagu
aktris	aktris
bertanam	ber @@tanam
mapan	mapan
dibanyak	di @@banyak
menyelesaikan	men @@selesai @@kan
penahan	pen @@tahan
diciptakannya	di @@cipta @@kan @@nya
mengagungkan	men @@agung @@kan
tongkatnya	tongkat @@nya
dikategori	di @@kategori
dinaikkan	di @@naik @@kan
ketidakpercayaan	ke @@tidak @@percaya @@an
nonmuslim	nonmuslim
pembesar	pen @@besar
penurunan	pen @@turun @@an
meluas	men @@luas
menjelang	men @@jelang
drama	drama
mengajarkannya	men @@ajar @@kan @@nya
tergantikan	ter @@ganti @@kan
dimekarkan	di @@mekar @@kan
perekam	pen @@rekam
nakal	nakal
teman	teman
kananmu	kanan @@mu
diraihnya	di @@raih @@nya
penting	penting
terdapatnya	ter @@dapat @@nya
sinar	sinar
ditembuskan	di @@tembus @@kan
premi	premi
pengoleksi	pen @@koleksi
tampilkan	tampil @@kan
membalas	men @@balas
dikecewakan	di @@kecewa @@kan
terwujudnya	ter @@wujud @@nya
pengadministrasiannya	pen @@administrasi @@an @@nya
mengutusnya	men @@utus @@nya
ulangan	ulang @@an
pengusulan	pen @@usul @@an
pengetahuannya	pengetahuan @@nya
dihancurkan	di @@hancur @@kan
menampik	men @@tampik
kakaknya	kakak @@nya
tindakannya	tindak @@an @@nya
menggelapkan	men @@gelap @@kan
presiden	presiden
terjadi	ter @@jadi
seutuhnya	se @@utuh @@nya
bervariasinya	ber @@variasi @@nya
tergabung	ter @@gabung
pengecualiannya	pengecualian @@nya
menggoreng	men @@goreng
dikasih	di @@kasih
harinya	hari @@nya
mengingatkannya	men @@ingat @@kan @@nya
galian	gali @@an
didanai	di @@dana @@i
orangtua	orangtua
menetes	men @@tetes
penghalang	pen @@halang
perumpamaan	per @@umpama @@an
bermigrasi	ber @@migrasi
tegak	tegak
ambisius	ambisius
perempuannya	perempuan @@nya
mengangkut	men @@angkut
lubang	lubang
menyalahkan	men @@salah @@kan
bicara	bicara
dimusyawarahkan	di @@musyawarah @@kan
mengizinkannya	men @@izin @@kan @@nya
akuisisi	akuisisi
bunyi	bunyi
diterima	di @@terima
pautnya	paut @@nya
tumbuh	tumbuh
pergi	pergi
pemeliharaan	pen @@pelihara @@an
kawannya	kawan @@nya
cuaca	cuaca
sebal	sebal
kaya	kaya
palungan	palung @@an
melatihnya	men @@latih @@nya
organ	organ
melambung	men @@lambung
amerika	amerika
mendayagunakan	men @@dayaguna @@kan
pemerintah	pen @@perintah
mengelompokkannya	men @@kelompok @@kan @@nya
penerbit	pen @@terbit
setulusnya	se @@tulus @@nya
menginformasikan	men @@informasi @@kan
merajut	men @@rajut
dikemukakan	di @@kemuka @@kan
manisnya	manis @@nya
perawatan	pen @@rawat @@an
tunjangannya	tunjang @@an @@nya
menahun	men @@tahun
raksasa	raksasa
menghargai	men @@harga @@i
regional	regional
sebaik	se @@baik
menyerupai	men @@serupa @@i
karbon	karbon
diterjunkan	di @@terjun @@kan
ketidakadilan	ke @@tidak @@adil @@an
diarahkan	di @@arah @@kan
kawanan	kawan @@an
pejuang	pejuang
penerbangan	pen @@terbang @@an
fotonya	foto @@nya
mencarikan	men @@cari @@kan
berbelok	ber @@belok
jurnal	jurnal
juru	juru
realokasi	realokasi
irak	irak
gedung	gedung
indeks	indeks
ditahan	di @@tahan
ditayangkan	di @@tayang @@kan
dibayar	di @@bayar
dihantam	di @@hantam
radio	radio
kira	kira
pelengkap	pen @@lengkap
gundul	gundul
gunanya	guna @@nya
kelahirannya	ke @@lahir @@an @@nya
penggelembungan	pen @@gelembung @@an
dicontoh	di @@contoh
pencapaiannya	pen @@capai @@an @@nya
pengapalan	pen @@kapal @@an
restoran	restoran
korup	korup
penandatangan	pen @@tandatangan
menganggarkan	men @@anggar @@kan
lanjutnya	lanjut @@nya
sosial	sosial
berjiwa	ber @@jiwa
menyentuh	men @@sentuh
bbm	bbm
angin	angin
pedesaannya	pedesaan @@nya
mutakhir	mutakhir
membolehkan	men @@boleh @@kan
limbah	limbah
kepemimpinannya	kepemimpinan @@nya
bernuansa	ber @@nuansa
merantai	men @@rantai
ajar	ajar
berteguh	ber @@teguh
terpandai	ter @@pandai
penyimpangan	pen @@simpang @@an
dipadati	di @@padat @@i
membusuk	men @@busuk
rutinitas	rutinitas
murah	murah
menunjukkan	men @@tunjuk @@kan
pendekatannya	pen @@dekat @@an @@nya
pelatih	pen @@latih
utang	utang
remeh	remeh
taksi	taksi
gula	gula
tema	tema
perlombaan	per @@lomba @@an
diperdakan	di @@perda @@kan
ruu	ruu
mini	min @@i
rumahnya	rumah @@nya
relevannya	relevan @@nya
mewah	mewah
pewawancara	pen @@wawancara
teratur	ter @@atur
sepakbola	sepakbola
pintar	pintar
berkemampuan	ber @@ke @@mampu @@an
kirimu	kiri @@mu
pemukiman	pen @@mukim @@an
mengulangnya	men @@ulang @@nya
mendefinisikan	men @@definisi @@kan
mendaur	men @@daur
kompilasi	kompilasi
statistik	statistik
daerahnya	daerah @@nya
persembunyiannya	per @@sembunyi @@an @@nya
kokoh	kokoh
berasas	ber @@asas
administrasinya	administrasi @@nya
gandum	gandum
menamai	men @@nama @@i
dilukis	di @@lukis
menyemburkan	men @@sembur @@kan
memanfaatkannya	men @@manfaat @@kan @@nya
wirausaha	wirausaha
modifikasi	modifikasi
menyulitkan	men @@sulit @@kan
diasumsikan	di @@asumsi @@kan
terpilihnya	ter @@pilih @@nya
katalis	katalis
terbelah	ter @@belah
mengesampingkan	men @@kesamping @@kan
kreditnya	kredit @@nya
gizinya	gizi @@nya
menelan	men @@telan
bulan	bulan
diperlihatkan	di @@per @@lihat @@kan
diancam	di @@ancam
ada	ada
hitung	hitung
pencurian	pen @@curi @@an
kucapai	ku @@capai
diselamatkan	di @@selamat @@kan
diseleksi	di @@seleksi
menyatakannya	men @@nyata @@kan @@nya
berkepentingan	ber @@ke @@penting @@an
tabrak	tabrak
kesudahan	ke @@sudah @@an
agunan	agun @@an
latihan	latih @@an
kemungkinan	kemungkinan
mengering	men @@kering
dipersulit	di @@per @@sulit
terbitkan	terbit @@kan
diberlakukannya	di @@ber @@laku @@kan @@nya
permohonan	per @@mohon @@an
meringkas	men @@ringkas
merancang	men @@rancang
pesanan	pesan @@an
mahabintang	mahabintang
antardusun	antar @@dusun
berpenghuni	ber @@pen @@huni
fragmen	fragmen
anggotanya	anggota @@nya
perencanaan	pen @@rencana @@an
tersinggung	ter @@singgung
penunjukan	pen @@tunjuk @@an
dikendorkan	di @@kendor @@kan
komunitas	komunitas
memonopoli	men @@monopoli
layanannya	layan @@an @@nya
membalasnya	men @@balas @@nya
bercacat	ber @@cacat
tersambar	ter @@sambar
mengubur	men @@kubur
tipe	tipe
pelita	pelita
kuba	kuba
akuntabilitasnya	akuntabilitas @@nya
globalisasi	globalisasi
meredam	men @@redam
dipelajari	di @@pelajar @@i
maksimalnya	maksimal @@nya
topi	top @@i
dagang	dagang
melintasinya	men @@lintas @@i @@nya
penjamuran	pen @@jamur @@an
perdana	perdana
penjatahan	pen @@jatah @@an
berakhirnya	ber @@akhir @@nya
bertahan	ber @@tahan
pemberi	pen @@beri
dinyatakan	di @@nyata @@kan
sampan	sampan
pendetanya	pendeta @@nya
ukiran	ukir @@an
koalisi	koalisi
menghambakan	men @@hamba @@kan
mengencerkan	men @@encer @@kan
ayahnya	ayah @@nya
karyanya	karya @@nya
dipulihkan	di @@pulih @@kan
kering	kering
edisi	edisi
mengacaukan	men @@kacau @@kan
mengungguli	men @@unggul @@i
diambang	di @@ambang
bendera	bendera
mertuanya	mertua @@nya
terjawab	ter @@jawab
ucapan	ucap @@an
diminatinya	di @@minat @@i @@nya
dimotori	di @@motor @@i
layang	layang
berperingkat	ber @@peringkat
ketidakselarasan	ke @@tidak @@selaras @@an
komunis	komunis
ongkos	ongkos
rukun	rukun
didaftar	di @@daftar
asing	asing
fisik	fisik
disuruh	di @@suruh
burung	burung
disentuh	di @@sentuh
menjulurkan	men @@julur @@kan
menghambat	men @@hambat
rekannya	rekan @@nya
tertahankan	ter @@tahan @@kan
telinga	telinga
dihimbau	di @@himbau
mendarat	men @@darat
gitar	gitar
realisasi	realisasi
pendesentralisasian	pen @@desentralisasi @@an
sidang	sidang
membencinya	men @@benci @@nya
dikorbankan	di @@korban @@kan
terendah	ter @@rendah
menganan	men @@kanan
mengumumkan	men @@umum @@kan
melantik	men @@lantik
ejekan	ejek @@an
umum	umum
dibiarkan	di @@biar @@kan
menciptakan	men @@cipta @@kan
mengajari	men @@ajar @@i
restrukturisasi	restrukturisasi
chevy	chevy
pisaunya	pisau @@nya
perdanya	perda @@nya
menyetorkan	men @@setor @@kan
tasnya	tas @@nya
hamba	hamba
melanggankan	men @@langgan @@kan
mengoleksi	men @@koleksi
generasi	generasi
konstitusi	konstitusi
ditambah	di @@tambah
pelayannya	pen @@layan @@nya
mulut	mulut
tersobek	ter @@sobek
cangkir	cangkir
penjangkauan	pen @@jangkau @@an
memanfaatkan	men @@manfaat @@kan
pengelolaan	pen @@kelola @@an
tersingkir	ter @@singkir
merangkum	men @@rangkum
rumor	rumor
terkubur	ter @@kubur
menduduki	men @@duduk @@i
kuda	kuda
korelasinya	korelasi @@nya
senior	senior
tiketnya	tiket @@nya
banknya	bank @@nya
selandia	selandia
mencukur	men @@cukur
murka	murka
lantainya	lantai @@nya
tokoh	tokoh
menghiburku	men @@hibur @@ku
perindustrian	per @@industri @@an
mengagendakan	men @@agenda @@kan
logonya	logo @@nya
sawah	sawah
menegur	men @@tegur
trendi	trend @@i
september	september
nasionalnya	nasional @@nya
skandalnya	skandal @@nya
gemuruhnya	gemuruh @@nya
sedekah	sedekah
etnis	etnis
jumat	jumat
didapati	di @@dapat @@i
pahamnya	paham @@nya
mobilnya	mobil @@nya
bertemakan	ber @@tema @@kan
budaknya	budak @@nya
mengejeknya	men @@ejek @@nya
ditiadakan	di @@tiada @@kan
wabah	wabah
berjudul	ber @@judul
menakjubkannya	men @@takjub @@kan @@nya
pantauan	pantau @@an
omongan	omong @@an
iuran	iuran
meratapi	men @@ratap @@i
juni	juni
artikelnya	artikel @@nya
menunggak	men @@tunggak
mengklaim	men @@klaim
benak	benak
menghangatkan	men @@hangat @@kan
berlanjutnya	ber @@lanjut @@nya
terpuruknya	ter @@puruk @@nya
pola	pola
pengiriman	pen @@kirim @@an
persekolahan	per @@sekolah @@an
partai	partai
panggil	panggil
deras	deras
anakku	anak @@ku
dirumuskan	di @@rumus @@kan
kairo	kairo
penyedia	pen @@sedia
debiturnya	debitur @@nya
pembimbingan	pen @@bimbing @@an
rahasia	rahasia
layaknya	layak @@nya
pinjam	pinjam
huni	huni
suspensi	suspensi
dituntut	di @@tuntut
memperdalam	men @@dalam
terinfeksi	ter @@infeksi
bentukan	bentuk @@an
areal	areal
teologiku	teologi @@ku
model	model
anggukan	angguk @@an
watak	watak
mempertegas	men @@tegas
ketidakberuntungan	ke @@tidak @@beruntung @@an
sekiranya	sekira @@nya
pengampunan	pen @@ampun @@an
secepatnya	se @@cepat @@nya
ibunya	ibu @@nya
tersesat	ter @@sesat
menjaminkan	men @@jamin @@kan
agenda	agenda
dipahaminya	di @@paham @@i @@nya
diboboli	di @@bobol @@i
penjahat	pen @@jahat
menganut	men @@anut
terdistribusikan	ter @@distribusi @@kan
menaikkan	men @@naik @@kan
garapan	garap @@an
dikupas	di @@kupas
ditandatangani	di @@tandatangan @@i
bicarakan	bicara @@kan
pihaknya	pihak @@nya
penghapusan	pen @@hapus @@an
dihasilkannya	di @@hasil @@kan @@nya
meneg	meneg
dilaporkan	di @@lapor @@kan
mengelilinginya	men @@keliling @@i @@nya
hakim	hakim
berdasarkan	ber @@dasar @@kan
aksesibilitas	aksesibilitas
sentuh	sentuh
kamar	kamar
diceritakan	di @@cerita @@kan
seusai	se @@usai
panti	panti
memerintahkan	men @@perintah @@kan
pengetikan	pen @@ketik @@an
batas	batas
menghakimi	men @@hakim @@i
ritel	ritel
bijih	bijih
mengajarinya	men @@ajar @@i @@nya
penulisannya	pen @@tulis @@an @@nya
pai	pai
seteguh	se @@teguh
jemu	jemu
dipersiapkan	di @@per @@siap @@kan
dijuluki	di @@juluk @@i
skor	skor
susut	susut
mendadak	mendadak
dilangsungkan	di @@langsung @@kan
perjuangan	per @@juang @@an
aceh	aceh
berjaga	ber @@jaga
pemberitaannya	pen @@berita @@an @@nya
musyawarah	musyawarah
memarkir	men @@parkir
fitnah	fitnah
sekretaris	sekretaris
terpakai	ter @@pakai
hati	hati
direlokasi	di @@relokasi
bakunya	baku @@nya
diimplementasikan	di @@implementasi @@kan
dipastikan	di @@pasti @@kan
ditinggal	di @@tinggal
sayuran	sayur @@an
bahan	bah @@an
terbuai	ter @@buai
pemilik	pen @@milik
kecurigaan	ke @@curiga @@an
perhubungan	per @@hubung @@an
penghancur	pen @@hancur
meninggalkannya	men @@tinggal @@kan @@nya
dikoordinasikan	di @@koordinasi @@kan
meriah	meriah
prosesnya	proses @@nya
mengakses	men @@akses
membayarkan	men @@bayar @@kan
kelanjutan	ke @@lanjut @@an
diampuni	di @@ampun @@i
riang	riang
pengatur	pen @@atur
moskow	moskow
tahanan	tahan @@an
mengaburkan	men @@kabur @@kan
melanda	men @@landa
diidentifikasikan	di @@identifikasi @@kan
mengulangi	men @@ulang @@i
mencemaskan	men @@cemas @@kan
antipesawat	anti @@pesawat
diresmikan	di @@resmi @@kan
didiknya	didik @@nya
simpang	simpang
dibagikan	di @@bagi @@kan
terserap	ter @@serap
tuju	tuju
menambah	men @@tambah
investasi	investasi
penyuluh	pen @@suluh
terakomodasinya	ter @@akomodasi @@nya
lingkar	lingkar
berstatus	ber @@status
sabaran	sabar @@an
warnanya	warna @@nya
diterapkan	di @@terap @@kan
serius	serius
pembobotan	pen @@bobot @@an
pelamar	pen @@lamar
memasarkan	men @@pasar @@kan
tumpangi	tumpang @@i
terpikir	ter @@pikir
dilacak	di @@lacak
harga	harga
tersajikan	ter @@saji @@kan
pembimbing	pen @@bimbing
halal	halal
perkreditan	per @@kredit @@an
diiringi	di @@iring @@i
dikonsentrasikan	di @@konsentrasi @@kan
berwilayah	ber @@wilayah
menyebarluaskan	men @@sebarluas @@kan
administratif	administratif
tereliminasi	ter @@eliminasi
jadinya	jadi @@nya
mengerikan	men @@ngeri @@kan
ikannya	ikan @@nya
merefleksikan	men @@refleksi @@kan
properti	properti
diakomodasi	di @@akomodasi
asumsi	asumsi
dihidangkan	di @@hidang @@kan
hangus	hangus
digodok	di @@godok
undi	undi
bank	bank
memedihkan	men @@pedih @@kan
nelayan	nelayan
penumpukan	pen @@tumpuk @@an
menginginkan	men @@ingin @@kan
dikte	dikte
pergantian	per @@ganti @@an
kisaran	kisar @@an
aset	aset
diskusi	diskusi
aniaya	aniaya
mengagunkan	men @@agun @@kan
maju	maju
minumannya	minum @@an @@nya
pencemaran	pen @@cemar @@an
sayang	sayang
pengasinan	pen @@asin @@an
langka	langka
memberinya	men @@beri @@nya
berbagi	ber @@bagi
pengobatannya	pen @@obat @@an @@nya
dilayani	di @@layan @@i
penanggung	pen @@tanggung
menangkal	men @@tangkal
sulitnya	sulit @@nya
ham	ham
berdedikasi	ber @@dedikasi
menentang	men @@tentang
junjunganku	junjung @@an @@ku
dewasa	dewasa
berbisik	ber @@bisik
wibawa	wibawa
tepung	tepung
adil	adil
terpelajar	ter @@pelajar
ayah	ayah
meleleh	men @@leleh
berkonotasi	ber @@konotasi
antarguru	antar @@guru
mati	mati
lagunya	lagu @@nya
penghasilan	pen @@hasil @@an
susu	susu
aparatnya	aparat @@nya
dugaan	duga @@an
merebak	men @@rebak
besar	besar
membekas	men @@bekas
tuamu	tua @@mu
refleksi	refleksi
memandangku	men @@pandang @@ku
merapikan	men @@rapi @@kan
pemutakhiran	pen @@mutakhir @@an
penganggur	pen @@anggur
biologis	biologis
dampingan	damping @@an
langkah	langkah
york	york
merestui	men @@restu @@i
yunani	yunani
mengencangkan	men @@kencang @@kan
kupelajari	ku @@pelajar @@i
diketuai	di @@ketua @@i
layani	layan @@i
setara	setara
merontokkan	men @@rontok @@kan
menghimpunkan	men @@himpun @@kan
takaran	takar @@an
kristen	kristen
ribut	ribut
silam	silam
larut	larut
dianut	di @@anut
intens	intens
terungkap	ter @@ungkap
gembira	gembira
sah	sah
meminimalisasi	men @@minimalisasi
reputasi	reputasi
menetap	men @@tetap
transaksinya	transaksi @@nya
pengamat	pengamat
diperberat	di @@per @@berat
melanjutkan	men @@lanjut @@kan
belulang	belulang
periksa	periksa
penetapan	pen @@tetap @@an
dihuni	di @@huni
tawa	tawa
pembersihan	pen @@bersih @@an
pahatan	pahat @@an
argumentasi	argumentasi
perairan	per @@air @@an
karunia	karunia
sihir	sihir
hasilkan	hasil @@kan
imajinasi	imajinasi
album	album
jelek	jelek
dibacanya	di @@baca @@nya
tropis	tropis
nonrumah	non @@rumah
menyelesaikannya	men @@selesai @@kan @@nya
bangun	bangun
karibia	karibia
menganyam	men @@anyam
banyak	banyak
lengkapnya	lengkap @@nya
penjualan	pen @@jual @@an
diadaptasi	di @@adaptasi
hiburan	hibur @@an
bus	bus
paginya	pagi @@nya
menempelkan	men @@tempel @@kan
menuruni	men @@turun @@i
simpatinya	simpati @@nya
berpawai	ber @@pawai
dirombak	di @@rombak
perampingan	pen @@ramping @@an
ditepatinya	di @@tepat @@i @@nya
tatapan	tatap @@an
mengorban	men @@korban
dialiri	di @@alir @@i
kecenderungan	kecenderungan
aktor	aktor
duta	duta
tersalurkan	ter @@salur @@kan
sulut	sulut
ekonomis	ekonomis
pendam	pendam
digabung	di @@gabung
menurun	men @@turun
mendengarnya	men @@dengar @@nya
audio	audio
pancaran	pancar @@an
masa	masa
bukunya	buku @@nya
membanjirnya	men @@banjir @@nya
penyangga	pen @@sangga
sokongan	sokong @@an
buatan	buat @@an
mengimani	men @@iman @@i
dideskripsikan	di @@deskripsi @@kan
piutang	piutang
terukur	ter @@ukur
mendanai	men @@dana @@i
ceritanya	cerita @@nya
arogan	arogan
prestasinya	prestasi @@nya
mereview	men @@review
terlihat	ter @@lihat
tertekan	ter @@tekan
jambangan	jambang @@an
seramai	se @@ramai
berteknologi	ber @@teknologi
menyederhanakannya	men @@sederhana @@kan @@nya
alumninya	alumni @@nya
federal	federal
menekankan	men @@tekan @@kan
stres	stres
dikuduskan	di @@kudus @@kan
dirahasiakan	di @@rahasia @@kan
mengangsur	men @@angsur
mendaratkan	men @@darat @@kan
pengabdiannya	pen @@abdi @@an @@nya
dirjen	dirjen
koperasinya	koperasi @@nya
mendisiplinkan	men @@disiplin @@kan
bermilik	ber @@milik
medan	medan
suami	suami
berbau	ber @@bau
tegas	tegas
pencairannya	pen @@cair @@an @@nya
bersusah	ber @@susah
dikerahkan	di @@kerah @@kan
dirampungkan	di @@rampung @@kan
kiamat	kiamat
dipublikasikan	di @@publikasi @@kan
intensifnya	intensif @@nya
jajarannya	jajar @@an @@nya
menyemprotkan	men @@semprot @@kan
menanggulangi	men @@tanggulang @@i
napasnya	napas @@nya
ayam	ayam
rumitnya	rumit @@nya
praktis	praktis
melayaninya	men @@layan @@i @@nya
kegemaran	ke @@gemar @@an
borongan	borong @@an
penertiban	pen @@tertib @@an
kamarmu	kamar @@mu
matang	matang
terkagum	ter @@kagum
muka	muka
terakomodasi	ter @@akomodasi
sukses	sukses
disabotase	di @@sabotase
rangkuman	rangkum @@an
perbelanjaan	per @@belanja @@an
pelibatan	pen @@libat @@an
pencairan	pen @@cair @@an
menginspirasi	men @@inspirasi
badak	badak
dihindari	di @@hindar @@i
daging	daging
alarm	alarm
pendata	pen @@data
aparat	aparat
tangannya	tangan @@nya
menganjurkan	men @@anjur @@kan
terlarang	ter @@larang
memusyawarahkannya	men @@musyawarah @@kan @@nya
rodanya	roda @@nya
bersandarkan	ber @@sandar @@kan
lestari	lestari
bebasnya	bebas @@nya
diperbaharui	di @@per @@baharu @@i
pemeta	pen @@peta
wiraswasta	wiraswasta
menumpahkan	men @@tumpah @@kan
longgar	longgar
dilibatkannya	di @@libat @@kan @@nya
keturunanmu	ke @@turun @@an @@mu
ditempat	di @@tempat
sekerja	se @@kerja
bobotnya	bobot @@nya
akademis	akademis
aslinya	asli @@nya
pemanfaatnya	pen @@manfaat @@nya
ditimbulkannya	di @@timbul @@kan @@nya
daftarkan	daftar @@kan
dihimpun	di @@himpun
kesempatannya	kesempatan @@nya
pelanggarannya	pen @@langgar @@an @@nya
termin	ter @@min
kendala	kendala
idenya	ide @@nya
indonesia	indonesia
menjejak	men @@jejak
berlantai	ber @@lantai
lembab	lembab
memprakarsai	men @@prakarsa @@i
dilanggar	di @@langgar
inovatif	inovatif
institusional	institusional
dini	din @@i
jawabnya	jawab @@nya
menepati	men @@tepat @@i
kotorannya	kotor @@an @@nya
bakaran	bakar @@an
terhubung	ter @@hubung
kejadian	ke @@jadi @@an
menghilang	men @@hilang
wasitnya	wasit @@nya
harfiah	harfiah
menata	men @@tata
dikirim	di @@kirim
calon	calon
memberontak	men @@berontak
pembayaran	pen @@bayar @@an
tanyakan	tanya @@kan
melemah	men @@lemah
pengaruhnya	pengaruh @@nya
tabrakan	tabrak @@an
jemaat	jemaat
takutkan	takut @@kan
menyapu	men @@sapu
pemberontak	pen @@berontak
mengkombinasikan	men @@kombinasi @@kan
sikap	sikap
cobaan	coba @@an
penyuling	pen @@suling
difoto	di @@foto
disiplin	disiplin
memulangkan	men @@pulang @@kan
bibir	bibir
lambat	lambat
lobang	lobang
mengganggunya	men @@ganggu @@nya
teringat	ter @@ingat
dipengaruhi	di @@pengaruh @@i
paduan	padu @@an
dipantau	di @@pantau
memperkenalkan	men @@kenal @@kan
pesertanya	peserta @@nya
penyebutan	pen @@sebut @@an
kolega	kolega
diterbitkannya	di @@terbit @@kan @@nya
tangguh	tangguh
pemicu	pen @@picu
mencetak	men @@cetak
meningkatnya	men @@tingkat @@nya
pengusung	pen @@usung
mekanisme	mekanisme
menendang	men @@tendang
kutempuh	ku @@tempuh
dihubungkan	di @@hubung @@kan
miliarder	miliarder
tembus	tembus
penjelas	pen @@jelas
ditekan	di @@tekan
dinegosiasikan	di @@negosiasi @@kan
kerinduan	ke @@rindu @@an
ciri	ciri
dukanya	duka @@nya
obyeknya	obyek @@nya
bersiap	ber @@siap
antarpeserta	antar @@peserta
syair	syair
laksana	laksana
komitmen	komitmen
hamil	hamil
membayangkan	men @@bayang @@kan
pisau	pisau
mahabintangnya	mahabintang @@nya
dihadiri	di @@hadir @@i
pemadaman	pen @@madam @@an
situ	situ
kelihatannya	ke @@lihat @@an @@nya
mentargetkan	men @@target @@kan
disambut	di @@sambut
merealisasikannya	men @@realisasi @@kan @@nya
menyedihkan	men @@sedih @@kan
botol	botol
eternitnya	eternit @@nya
takjub	takjub
komersial	komersial
pertokoan	per @@toko @@an
serangkaian	se @@rangkaian
mobil	mobil
perenungannya	pen @@renung @@an @@nya
diuntungkan	di @@untung @@kan
musuhnya	musuh @@nya
mengomentari	men @@komentar @@i
laptop	laptop
gerai	gerai
diobservasi	di @@observasi
konsultasi	konsultasi
tersier	tersier
administrasi	administrasi
kepergianku	ke @@pergi @@an @@ku
sedahsyat	se @@dahsyat
prasangka	prasangka
impiannya	impian @@nya
seadat	se @@adat
akademi	akademi
bernegara	ber @@negara
penyiaran	pen @@siar @@an
afrika	afrika
pembasmi	pen @@basmi
direvisi	di @@revisi
teks	teks
cinta	cinta
citranya	citra @@nya
diserahi	di @@serah @@i
mengangkat	men @@angkat
bertenaga	ber @@tenaga
dinikahkan	di @@nikah @@kan
jatahnya	jatah @@nya
bergelar	ber @@gelar
penularan	pen @@tular @@an
jabodetabek	jabodetabek
mainnya	main @@nya
kufirmankan	ku @@firman @@kan
menyiramnya	men @@siram @@nya
pelaksana	pen @@laksana
syairnya	syair @@nya
ketuanya	ketua @@nya
merek	merek
menyandarkan	men @@sandar @@kan
berulang	ber @@ulang
kerabatnya	kerabat @@nya
domba	domba
dituduh	di @@tuduh
bunuh	bunuh
melawannya	men @@lawan @@nya
hasil	hasil
coklat	coklat
bersih	bersih
berbuat	ber @@buat
ketidaktepatan	ke @@tidak @@tepat @@an
bedanya	beda @@nya
terbangnya	terbang @@nya
bertubuh	ber @@tubuh
kotanya	kota @@nya
iman	iman
penyumbang	pen @@sumbang
ibu	ibu
pemberian	pen @@beri @@an
lintas	lintas
relasinya	relasi @@nya
menitip	men @@titip
mengungsi	men @@ungsi
lentur	lentur
menanggapinya	men @@tanggap @@i @@nya
penyusunan	pen @@susun @@an
arang	arang
pewahyuan	pen @@wahyu @@an
menggemparkan	men @@gempar @@kan
bekasi	bekas @@i
perekonomiannya	per @@ekonomi @@an @@nya
mencapainya	men @@capai @@nya
mengarahkanku	men @@arah @@kan @@ku
antarklub	antar @@klub
didengarkan	di @@dengar @@kan
diambilnya	di @@ambil @@nya
suksesnya	sukses @@nya
dimintai	di @@minta @@i
nya	nya
diperanakkan	di @@per @@anak @@kan
definisinya	definisi @@nya
menggembala	men @@gembala
meratanya	men @@rata @@nya
pembenahan	pen @@benah @@an
ramping	ramping
menghilangnya	men @@hilang @@nya
gerutu	gerutu
cermin	cermin
dibedakan	di @@beda @@kan
dikritik	di @@kritik
berganti	ber @@ganti
menginterpretasikannya	men @@interpretasi @@kan @@nya
memperbolehkan	men @@boleh @@kan
berpuasa	ber @@puasa
dipasang	di @@pasang
dosennya	dosen @@nya
skemanya	skema @@nya
berjumpa	ber @@jumpa
klarifikasi	klarifikasi
sepihak	se @@pihak
antarbadan	antar @@badan
pangsa	pangsa
memaparkan	men @@papar @@kan
benci	benci
mencurigai	men @@curiga @@i
pulih	pulih
disetor	di @@setor
didiagnosa	di @@diagnosa
penindakan	pen @@tindak @@an
bertempur	ber @@tempur
disalahkan	di @@salah @@kan
ketidakpuasannya	ke @@tidak @@puas @@an @@nya
jabatan	jabat @@an
kabul	kabul
game	game
laparnya	lapar @@nya
merekonstruksi	men @@rekonstruksi
pendistribusi	pen @@distribusi
dibayarkan	di @@bayar @@kan
tahan	tahan
melaporkan	men @@lapor @@kan
sidik	sidik
pungutan	pungut @@an
panggung	panggung
halus	halus
ganjil	ganjil
pengamatan	pengamat @@an
memberantas	men @@berantas
audit	audit
dikendalikan	di @@kendali @@kan
lancarnya	lancar @@nya
menyertifikasi	men @@sertifikasi
biji	biji
pengorbanan	pen @@korban @@an
terisolasi	ter @@isolasi
mengendalikan	men @@kendali @@kan
memulihkannya	men @@pulih @@kan @@nya
pengeluaran	pen @@keluar @@an
sepatah	se @@patah
fleksibilitas	fleksibilitas
disepelekan	di @@sepele @@kan
mereda	men @@reda
pikiran	pikir @@an
jeruknya	jeruk @@nya
kerasukan	ke @@rasuk @@an
protein	protein
menggantung	men @@gantung
terdalam	ter @@dalam
menggadaikan	men @@gadai @@kan
tulisannya	tulis @@an @@nya
menyadarkan	men @@sadar @@kan
visinya	visi @@nya
listrik	listrik
melenyapkan	men @@lenyap @@kan
paket	paket
kapnya	kap @@nya
mendapatinya	men @@dapat @@i @@nya
tertimpa	ter @@timpa
palsu	palsu
konsisten	konsisten
umatnya	umat @@nya
janggal	janggal
bimbingan	bimbing @@an
diambilkan	di @@ambil @@kan
penuh	penuh
juruselamatnya	juruselamat @@nya
organisasi	organisasi
persediaan	per @@sedia @@an
melangsungkan	men @@langsung @@kan
ditabrak	di @@tabrak
diberikan	di @@beri @@kan
aktual	aktual
pencair	pen @@cair
penanganannya	pen @@tangan @@an @@nya
sayur	sayur
terakhir	ter @@akhir
kemarau	kemarau
pemisahan	pen @@pisah @@an
mengelolanya	men @@kelola @@nya
orde	orde
ditembak	di @@tembak
peledak	pen @@ledak
berdalih	ber @@dalih
berinduk	ber @@induk
gigi	gigi
dramatis	dramatis
dipanggang	di @@panggang
pacu	pacu
tektonik	tektonik
tekanan	tekan @@an
turbin	turbin
diagnosanya	nyagnosa @@nya
menyuap	men @@suap
pembekalan	pen @@bekal @@an
beratnya	berat @@nya
pertenunan	per @@tenun @@an
solo	solo
pemancing	pen @@pancing
udang	udang
mengaliri	men @@alir @@i
penginjil	pen @@injil
bibinya	bibi @@nya
antisipasi	antisipasi
slogan	slogan
koordinasinya	koordinasi @@nya
usus	usus
corak	corak
pembaruannya	pen @@baru @@an @@nya
pegawai	pegawai
buka	buka
kuingin	ku @@ingin
pengirim	pen @@kirim
roda	roda
emosi	emosi
perseroan	perseroan
dititipkannya	di @@titip @@kan @@nya
dicurangi	di @@curang @@i
menetapkan	men @@tetap @@kan
aksi	aksi
mengimunisasi	men @@imunisasi
jantung	jantung
memperbincangkan	men @@bincang @@kan
penggarap	pen @@garap
sumberdayanya	sumberdaya @@nya
benua	benua
dekan	dek @@an
diperkenalkan	di @@per @@kenal @@kan
dahaga	dahaga
dusun	dusun
payung	payung
kelahiran	ke @@lahir @@an
berorang	ber @@orang
berpendapatan	ber @@pen @@dapat @@an
mengambilkanku	men @@ambil @@kan @@ku
perhatian	per @@hati @@an
romawi	romawi
durhaka	durhaka
bengkok	bengkok
merangsang	men @@rangsang
kebohongan	ke @@bohong @@an
pengorbanannya	pen @@korban @@an @@nya
mitranya	mitra @@nya
bukti	bukti
membekukan	men @@beku @@kan
rutinitasnya	rutinitas @@nya
pemimpin	pen @@pimpin
persneling	persneling
penggodokan	pen @@godok @@an
menepis	men @@tepis
mewajibkan	men @@wajib @@kan
menggiatkan	men @@giat @@kan
ngerinya	ngeri @@nya
beradu	ber @@adu
tersulut	ter @@sulut
subjektivitas	subjektivitas
melapor	men @@lapor
antagonis	antagonis
enak	enak
tesisnya	tesis @@nya
kotornya	kotor @@nya
perpustakaan	perpustakaan
terpenuhinya	men @@penuh @@i @@nya
kontroversi	kontroversi
sisi	sisi
detik	detik
melatarbelakangi	men @@latarbelakang @@i
paku	paku
pekerjaan	pekerja @@an
hargai	harga @@i
ditjen	ditjen
fasih	fasih
tekad	tekad
informasi	informasi
kejadianku	ke @@jadi @@an @@ku
diadukan	di @@adu @@kan
foto	foto
memperburuk	men @@buruk
menjauhkan	men @@jauh @@kan
karung	karung
didikan	didik @@an
pengimplementasian	pen @@implementasi @@an
ungkap	ungkap
mencukupinya	men @@cukup @@i @@nya
dicari	di @@cari
haluan	halu @@an
disipliner	disipliner
berakting	ber @@akting
mengenali	men @@kenal @@i
kabur	kabur
tradisi	tradisi
rutinnya	rutin @@nya
sangsi	sangsi
mengucilkan	men @@kucil @@kan
ri	ri
biayanya	biaya @@nya
sempurnanya	sempurna @@nya
tandan	tandan
diundur	di @@undur
bangsanya	bangsa @@nya
berlangganan	ber @@langgan @@an
terdengar	ter @@dengar
bolos	bolos
ditinggikan	di @@tinggi @@kan
dibuatkan	di @@buat @@kan
terkunci	ter @@kunci
menyeleksi	men @@seleksi
smp	smp
menggendong	men @@gendong
talak	talak
mencapai	men @@capai
aktif	aktif
memimpin	men @@pimpin
mengajarku	men @@ajar @@ku
mutu	mutu
disingkat	di @@singkat
memilih	men @@pilih
ganda	ganda
katalog	katalog
ditempelkan	di @@tempel @@kan
pemilahan	pen @@pilah @@an
pemerintahnya	pen @@perintah @@nya
penghuninya	pen @@huni @@nya
mengharmoniskan	men @@harmonis @@kan
seismik	seismik
buku	buku
singkatan	singkat @@an
dapatkan	dapat @@kan
persimpangan	per @@simpang @@an
berjubahkan	ber @@jubah @@kan
dipercayai	di @@percaya @@i
sepesawat	se @@pesawat
pengering	pen @@kering
berawalan	ber @@awal @@an
keluarkan	keluar @@kan
batuan	batu @@an
ajang	ajang
heran	heran
ditenderkan	di @@tender @@kan
terduga	ter @@duga
terjaganya	ter @@jaga @@nya
mengandung	men @@kandung
tabel	tabel
terjangan	terjang @@an
kasus	kasus
kontak	kontak
teliti	teliti
cairnya	cair @@nya
wajan	wajan
mengintegrasikan	men @@integrasi @@kan
siswa	siswa
menyiram	men @@siram
rotasi	rotasi
azas	azas
mendapatkannya	men @@dapat @@kan @@nya
laki	laki
kandang	kandang
jubahnya	jubah @@nya
hungaria	hungaria
pemecatan	pen @@pecat @@an
kutipan	kutip @@an
merangkap	men @@rangkap
berangin	ber @@angin
diurai	di @@urai
biskuit	biskuit
penganiayaan	pen @@aniaya @@an
meluasnya	men @@luas @@nya
lirik	lirik
tersisihkan	ter @@sisih @@kan
surutnya	surut @@nya
perumahan	pen @@rumah @@an
menutup	men @@tutup
merevisi	men @@revisi
mengapung	men @@apung
membicarakan	men @@bicara @@kan
mengunjungi	men @@kunjung @@i
dibebani	di @@beban @@i
pembentukannya	pen @@bentuk @@an @@nya
andalkan	andal @@kan
baku	baku
merampingkan	men @@ramping @@kan
tumpang	tumpang
muat	muat
pelembagaan	pen @@lembaga @@an
perhatikan	perhatikan
jarum	jarum
transparan	transparan
pemukimannya	pen @@mukim @@an @@nya
berkelanjutan	ber @@ke @@lanjut @@an
memfokuskan	men @@fokus @@kan
perselisihan	per @@selisih @@an
ditempatkan	di @@tempat @@kan
penjudi	pen @@judi
terjaminnya	ter @@jamin @@nya
menguasainya	men @@kuasa @@i @@nya
secangkir	se @@cangkir
diakuinya	di @@aku @@i @@nya
setahap	se @@tahap
menerapkan	men @@terap @@kan
kasihmu	kasih @@mu
penimbunan	pen @@timbun @@an
dikeluhkan	di @@keluh @@kan
kiosnya	kios @@nya
medisnya	medis @@nya
tangani	tangan @@i
maksud	maksud
puncak	puncak
pipa	pipa
menangis	men @@tangis
diremehkan	di @@remeh @@kan
antartingkatan	antar @@tingkat @@an
dihargai	di @@harga @@i
dibentuk	di @@bentuk
gugur	gugur
dirawat	di @@rawat
seminggu	se @@minggu
pestanya	pesta @@nya
menerimanya	men @@terima @@nya
pelajari	pelajar @@i
mencatatkan	men @@catat @@kan
miliknya	milik @@nya
dibersihkan	di @@bersih @@kan
penambah	pen @@tambah
penghargaan	pen @@harga @@an
kecewa	kecewa
keinginan	ke @@ingin @@an
analisis	analisis
mengajarnya	men @@ajar @@nya
proposal	proposal
departemennya	departemen @@nya
mewarnai	men @@warna @@i
sekaleng	se @@kaleng
pembina	pen @@bina
rekornya	rekor @@nya
berwarna	ber @@warna
dataran	datar @@an
dibuatkannya	di @@buat @@kan @@nya
mencirikan	men @@ciri @@kan
biola	biola
mencangkul	men @@cangkul
awal	awal
pandai	pandai
disalahgunakan	di @@salahguna @@kan
esa	esa
dikutuk	di @@kutuk
cemar	cemar
wajahnya	wajah @@nya
kemunculan	ke @@muncul @@an
kalender	kalender
dikonversi	di @@konversi
berdekatan	ber @@dekat @@an
pendaftar	pen @@daftar
dihindarinya	di @@hindar @@i @@nya
menangisi	men @@tangis @@i
melebihi	men @@lebih @@i
rendahnya	rendah @@nya
searah	se @@arah
beragama	ber @@agama
politik	politik
jati	jati
minimal	minimal
berkeliling	ber @@keliling
melangkahkan	men @@langkah @@kan
jeda	jeda
semisal	se @@misal
diselaraskan	di @@selaras @@kan
terbunuh	ter @@bunuh
menulari	men @@tular @@i
dipraktekkan	di @@praktek @@kan
pelajarannya	pelajar @@an @@nya
digarisbawahi	di @@garisbawah @@i
mencuci	men @@cuci
bertempat	ber @@tempat
senang	senang
wahyu	wahyu
penumpangan	pen @@tumpang @@an
pengambilalihan	pen @@ambilalih @@an
dilampiri	di @@lampir @@i
memblok	men @@blok
penyesuaian	pen @@sesuai @@an
disiasati	di @@siasat @@i
balok	balok
terikatnya	ter @@ikat @@nya
dibawa	di @@bawa
jambu	jambu
pikirannya	pikir @@an @@nya
penjagaan	pen @@jaga @@an
tengahnya	tengah @@nya
hewan	hewan
kenaikan	ke @@naik @@an
strategis	strategis
bandung	bandung
meloloskan	men @@lolos @@kan
kemungkinannya	kemungkinan @@nya
jaraknya	jarak @@nya
kepalanya	kepala @@nya
mengevakuasi	men @@evakuasi
kecap	kecap
bijaksana	bijaksana
bisnisnya	bisnis @@nya
pembubaran	pen @@bubar @@an
berasal	ber @@asal
mengatasinya	men @@atas @@i @@nya
lemparan	lempar @@an
lega	lega
berlayar	ber @@layar
mengasihi	men @@kasih @@i
dermaga	dermaga
alkitab	alkitab
dikontrakkan	di @@kontrak @@kan
pengiring	pen @@iring
sabun	sabun
ditafsirkan	di @@tafsir @@kan
ditelepon	di @@telepon
terberat	ter @@berat
terbentang	ter @@bentang
dimusnahkan	di @@musnah @@kan
perbaiki	perbaiki
merawati	men @@rawat @@i
diikuti	di @@ikut @@i
riba	riba
mengagumi	men @@kagum @@i
mendiskusikannya	men @@diskusi @@kan @@nya
cakap	cakap
pelintasan	pen @@lintas @@an
istilahnya	istilah @@nya
mawarnya	mawar @@nya
trend	trend
jumpa	jumpa
dewasanya	dewasa @@nya
membujuk	men @@bujuk
menyesali	men @@sesal @@i
kumulatif	kumulatif
memegang	men @@pegang
analisi	analis @@i
rambutku	rambut @@ku
penambang	pen @@tambang
alam	alam
kafein	kafein
penebus	pen @@tebus
dibutuhkannya	di @@butuh @@kan @@nya
lingkungan	lingkung @@an
kisah	kisah
tren	tren
menyeragamkan	men @@seragam @@kan
angsuran	angsur @@an
menyiarkannya	men @@siar @@kan @@nya
pendatang	pen @@datang
pendukung	pen @@dukung
berukuran	ber @@ukur @@an
menggolongkan	men @@golong @@kan
selebihnya	se @@lebih @@nya
ramalan	ramal @@an
antarinstansi	antar @@instansi
asian	asian
penambangan	pen @@tambang @@an
memperkosa	men @@perkosa
tersulit	ter @@sulit
ditanggulangi	di @@tanggulang @@i
menyeberangi	men @@seberang @@i
dermaganya	dermaga @@nya
terjun	terjun
ditanggapi	di @@tanggap @@i
peninggalan	pen @@tinggal @@an
bermasyarakat	ber @@masyarakat
memperkuat	men @@kuat
mampuan	mampu @@an
perabotan	perabot @@an
pengurangan	pen @@kurang @@an
jawabannya	jawab @@an @@nya
menenangkan	men @@tenang @@kan
diingatkan	di @@ingat @@kan
gaul	gaul
mengupas	men @@kupas
buruknya	buruk @@nya
perencana	pen @@rencana
hormati	hormat @@i
petinggi	petinggi
mempertahankan	men @@tahan @@kan
terpaut	ter @@paut
reporter	reporter
tepuk	tepuk
kedengarannya	ke @@dengar @@an @@nya
mengumpulkan	men @@kumpul @@kan
bendahara	bendahara
laporan	lapor @@an
tentu	tentu
tertumpuk	ter @@tumpuk
direkam	di @@rekam
penyitaan	pen @@sita @@an
menyingkir	men @@singkir
disetujuinya	di @@setuju @@i @@nya
kelelawar	kelelawar
menegarkan	men @@tegar @@kan
renovasi	renovasi
dinamis	dinamis
situasinya	situasi @@nya
omong	omong
menakutkan	men @@takut @@kan
digelar	di @@gelar
dikunjungi	di @@kunjung @@i
substansi	substansi
merusak	men @@rusak
dihadirkan	di @@hadir @@kan
samping	samping
diredam	di @@redam
membebaskannya	men @@bebas @@kan @@nya
material	material
wawancara	wawancara
raga	raga
permanennya	permanen @@nya
pembahas	pen @@bahas
salinannya	salin @@an @@nya
independen	independen
berkomitmen	ber @@komitmen
direktorat	direktorat
frekuensi	frekuensi
pilot	pilot
bereaksi	ber @@reaksi
lokasinya	lokasi @@nya
liga	liga
terkuras	ter @@kuras
menjuarai	men @@juara @@i
goyang	goyang
hubungi	hubung @@i
berbuah	ber @@buah
mengupayakan	men @@upaya @@kan
gemuk	gemuk
antarwarga	antar @@warga
aktivitasnya	aktivitas @@nya
besaran	besar @@an
berinovasi	ber @@inovasi
gelapnya	gelap @@nya
cd	cd
volume	volume
internal	internal
gigitannya	gigit @@an @@nya
dibolehkan	di @@boleh @@kan
penjelasan	pen @@jelas @@an
serinci	se @@rinci
menghadapi	men @@hadap @@i
galangan	galang @@an
penyusup	pen @@susup
pendidikan	pen @@didik @@an
mengimpor	men @@impor
dikepung	di @@kepung
lorong	lorong
loncatan	loncat @@an
dijual	di @@jual
investigasi	investigasi
lkm	lkm
urutan	urut @@an
prakarsa	prakarsa
profesional	profesional
digembalakan	di @@gembala @@kan
terdiri	ter @@diri
sarapan	sarapan
kuburan	kubur @@an
sadari	sadar @@i
pemadam	pen @@madam
dilandasi	di @@landas @@i
berbalik	ber @@balik
bernalar	ber @@nalar
mendulang	men @@dulang
peduli	peduli
berekspresi	ber @@ekspresi
dibilang	di @@bilang
oknum	oknum
mendalam	men @@dalam
dikawal	di @@kawal
tiba	tiba
menjauhi	men @@jauh @@i
salahnya	salah @@nya
pelimpahan	pen @@limpah @@an
alternatif	alternatif
tertempel	ter @@tempel
menyegarkan	men @@segar @@kan
persoalan	per @@soal @@an
profesor	profesor
merindukan	men @@rindu @@kan
lamanya	lama @@nya
darahku	darah @@ku
terkonsolidasi	ter @@konsolidasi
pembengkakan	pen @@bengkak @@an
alkitabnya	alkitab @@nya
konsumen	konsumen
perusahaan	per @@usaha @@an
isu	isu
ragam	ragam
efisiensi	efisiensi
pemangku	pen @@pangku
kutanggung	ku @@tanggung
diucapkan	di @@ucap @@kan
buah	buah
parit	parit
ketidakseimbangan	ke @@tidak @@seimbang @@an
merobohkan	men @@roboh @@kan
memadainya	memadai @@nya
dikaruniai	di @@karunia @@i
peran	peran
membutakan	men @@buta @@kan
negarawan	negara @@wan
ditelan	di @@telan
menyesal	men @@sesal
pedagang	pedagang
diubah	di @@ubah
pewaris	pen @@waris
memberhentikan	men @@ber @@henti @@kan
perpanjangan	per @@panjang @@an
terkorup	ter @@korup
penggusuran	pen @@gusur @@an
sasaran	sasar @@an
perpaduan	per @@padu @@an
penyeludupan	pen @@seludup @@an
menyibukkan	men @@sibuk @@kan
pujikan	puji @@kan
diunduh	di @@unduh
kebalikannya	ke @@balik @@an @@nya
akibatkan	akibat @@kan
menanganinya	men @@tangan @@i @@nya
dinikahi	di @@nikah @@i
mesin	mesin
selembar	se @@lembar
mengemudi	men @@kemudi
bibit	bibit
pemblokiran	pen @@blokir @@an
produktivitasnya	produktivitas @@nya
penagih	pen @@tagih
pencucian	pen @@cuci @@an
gulung	gulung
gamblang	gamblang
penyadaran	pen @@sadar @@an
semudah	se @@mudah
efektifnya	efektif @@nya
disiapkannya	di @@siap @@kan @@nya
tercakup	ter @@cakup
rapuh	rapuh
bibirnya	bibir @@nya
wajib	wajib
anggur	anggur
sepatunya	sepatu @@nya
pelanggan	pen @@langgan
dikonfirmasi	di @@konfirmasi
memperindah	men @@indah
disingkirkan	di @@singkir @@kan
menayangkan	men @@tayang @@kan
menerpanya	men @@terpa @@nya
jangkauan	jangkau @@an
permanen	permanen
disyukuri	di @@syukuri
berlimpahnya	ber @@limpah @@nya
kinerja	kinerja
disingkapkan	di @@singkap @@kan
bercela	ber @@cela
waduk	waduk
menyambung	men @@sambung
bajak	bajak
pertanggungan	per @@tanggung @@an
progresif	progresif
dipersepsikan	di @@persepsi @@kan
kalifornia	kalifornia
kolonel	kolonel
didik	didik
diasosiasikan	di @@asosiasi @@kan
pendarahan	pen @@darah @@an
tradisional	tradisional
tonton	tonton
maraknya	marak @@nya
diletakkan	di @@letak @@kan
berlimpah	ber @@limpah
bermukim	ber @@mukim
konferensi	konferensi
produktivitas	produktivitas
suci	suci
ketik	ketik
sd	sd
perenungan	pen @@renung @@an
memihak	men @@pihak
gantinya	ganti @@nya
penafsiran	pen @@tafsir @@an
laksanakan	laksana @@kan
anugerahkan	anugerah @@kan
menyusul	men @@susul
penugasan	pen @@tugas @@an
gulat	gulat
sederajat	se @@derajat
nonpungutan	non @@pungut @@an
percayakan	percaya @@kan
diseret	di @@seret
mengutamakan	men @@utama @@kan
konsepnya	konsep @@nya
usulkan	usul @@kan
pindahan	pindah @@an
bergulat	ber @@gulat
kompeten	kompeten
konsumsinya	konsumsi @@nya
ditanamkan	di @@tanam @@kan
kontribusinya	kontribusi @@nya
ditentang	di @@tentang
menerbangkan	men @@terbang @@kan
perda	perda
raja	raja
unsur	unsur
darurat	darurat
indikatornya	indikator @@nya
rakyatnya	rakyat @@nya
diyakini	di @@yakin @@i
dilanjutkannya	di @@lanjut @@kan @@nya
demonstran	demonstran
terperangkap	ter @@pen @@rangkap
lidah	lidah
bercirikan	ber @@ciri @@kan
dicontohkan	di @@contoh @@kan
hipotesis	hipotesis
menyanyikan	men @@nyanyi @@kan
dadaku	dada @@aku
minim	minim
mengalirnya	men @@alir @@nya
menjangkaunya	men @@jangkau @@nya
tagih	tagih
merusakkannya	men @@rusak @@kan @@nya
pengajarnya	pen @@ajar @@nya
versi	versi
membuktikannya	men @@bukti @@kan @@nya
efektif	efektif
tajuk	tajuk
kotak	kotak
dibacakan	di @@baca @@kan
sengit	sengit
usulannya	usul @@an @@nya
peternakan	peternakan
kategorisasi	kategorisasi
kontribusi	kontribusi
istimewa	istimewa
pelantikannya	pen @@lantik @@an @@nya
penggenapan	pen @@genap @@an
tinggal	tinggal
dipunyai	di @@punya @@i
penyebaran	pen @@sebar @@an
digadaikan	di @@gadai @@kan
mengundurkan	men @@undur @@kan
berusia	ber @@usia
sistemnya	sistem @@nya
perekonomian	per @@ekonomi @@an
spekulasi	spekulasi
penargetannya	pen @@target @@an @@nya
pertolongan	per @@tolong @@an
berasumsi	ber @@asumsi
hariannya	hari @@an @@nya
menghampiri	men @@hampiri
dagingku	daging @@ku
handuk	handuk
berprestasi	ber @@prestasi
membesar	men @@besar
menggerutu	men @@gerutu
arus	arus
relevansi	relevansi
menyerang	men @@serang
selimut	selimut
seisi	se @@isi
diprediksikan	di @@prediksi @@kan
memprioritaskan	men @@prioritas @@kan
dijunjung	di @@junjung
skandal	skandal
mempekerjakan	men @@pekerja @@kan
ketidakbahagiaan	ke @@tidak @@bahagia @@an
hening	hening
agung	agung
selisihnya	selisih @@nya
dicap	di @@cap
teladannya	teladan @@nya
legal	legal
dimotivasi	di @@motivasi
tubuh	tubuh
sejawat	se @@jawat
produktifitas	produktifitas
derajat	derajat
banjir	banjir
keberangkatan	ke @@berangkat @@an
bersasaran	ber @@sasar @@an
pemberitahuan	pen @@beritahu @@an
unjuk	unjuk
layanan	layan @@an
profesionalnya	profesional @@nya
diagendakan	di @@agenda @@kan
pemantau	pen @@pantau
melainkan	men @@lain @@kan
penghimpunan	pen @@himpun @@an
pengasih	pen @@kasih
uangnya	uang @@nya
nota	nota
berkarier	ber @@karier
kelihatan	ke @@lihat @@an
diubahkan	di @@ubah @@kan
dilukai	di @@luka @@i
ikuti	ikut @@i
berartinya	ber @@arti @@nya
figur	figur
mencoba	men @@coba
tersalib	ter @@salib
terhitung	ter @@hitung
bayangan	bayang @@an
menggairahkan	men @@gairah @@kan
terintegrasi	ter @@integrasi
pandang	pandang
pelempar	pen @@lempar
mematuhi	men @@patuh @@i
punyai	punya @@i
kucingnya	kucing @@nya
berinvestasi	ber @@investasi
mentransfer	men @@transfer
untungnya	untung @@nya
melancarkan	men @@lancar @@kan
sumbernya	sumber @@nya
mengendarai	men @@kendara @@i
tekstil	tekstil
pemasoknya	pen @@pasok @@nya
menirukan	men @@tiru @@kan
bermunculan	ber @@muncul @@an
dimengerti	di @@mengerti
sampaikan	sampai @@kan
dipisahkan	di @@pisah @@kan
nyanyiannya	nyanyi @@an @@nya
melemahkan	men @@lemah @@kan
menyaksikan	men @@saksi @@kan
kesal	kesal
mekaniknya	mekanik @@nya
gantung	gantung
perampokan	pen @@rampok @@an
ditantang	di @@tantang
mengendurkan	men @@kendur @@kan
nonsaham	non @@saham
disebarkan	di @@sebar @@kan
percakapan	per @@cakap @@an
manuver	manuver
aksesnya	akses @@nya
titik	titik
disalibkan	di @@salib @@kan
polandia	polandia
simak	simak
sensitif	sensitif
pengajarannya	pen @@ajar @@an @@nya
tumbuhnya	tumbuh @@nya
bunga	bunga
bermerk	ber @@merk
tuanmu	tuan @@mu
berkelimpahan	ber @@ke @@limpah @@an
pasalnya	pasal @@nya
manufaktur	manufaktur
ternaknya	ternak @@nya
fasilitator	fasilitator
sejam	se @@jam
semenit	se @@menit
melompat	men @@lompat
menimbulkan	men @@timbul @@kan
seiman	se @@iman
cerita	cerita
berakhir	ber @@akhir
bidang	bidang
kompleks	kompleks
otaknya	otak @@nya
tersendiri	ter @@sendiri
sedihan	sedih @@an
beraneka	ber @@aneka
kebangunan	ke @@bangun @@an
wacana	wacana
penjaja	pen @@jaja
timbal	timbal
canada	canada
diminum	di @@minum
pengantar	pen @@antar
menolak	men @@tolak
terlaksananya	ter @@laksana @@nya
rohaninya	rohani @@nya
reproduksi	reproduksi
dimampukan	di @@mampu @@kan
penjabaran	pen @@jabar @@an
mencuri	men @@curi
menyurati	men @@surat @@i
memancar	men @@pancar
sama	sama
ketidakharmonisan	ke @@tidak @@harmonis @@an
bijak	bijak
berimbangnya	ber @@imbang @@nya
secepat	se @@cepat
cadangannya	cadang @@an @@nya
pencegah	pen @@cegah
pemantapan	pen @@mantap @@an
punggung	punggung
papan	papan
tertahan	ter @@tahan
instansi	instansi
syafaat	syafaat
mengarahkannya	men @@arah @@kan @@nya
penyajian	pen @@saji @@an
menguasai	men @@kuasa @@i
menerpa	men @@terpa
antarsekolah	antar @@sekolah
tujukan	tuju @@kan
setia	setia
turunnya	turun @@nya
rekrut	rekrut
mengamati	men @@amati
pengestimasian	pen @@estimasi @@an
tubuhnya	tubuh @@nya
berdamai	ber @@damai
survei	survei
pengamanan	pen @@aman @@an
harta	harta
terlewatkan	ter @@lewat @@kan
kalanya	kala @@nya
berkedudukan	ber @@ke @@duduk @@an
dibatasi	di @@batas @@i
belalai	belalai
pengertian	pengertian
terpangkas	ter @@pangkas
penghiburan	pen @@hibur @@an
terampuh	ter @@ampuh
nonpemerintah	non @@pen @@perintah
olah	olah
jurnalnya	jurnal @@nya
komersialnya	komersial @@nya
disamakan	di @@sama @@kan
senasib	se @@nasib
kompetisi	kompetisi
legislatif	legislatif
bab	bab
mencurahkan	men @@curah @@kan
pendapatan	pen @@dapat @@an
wisatawan	wisata @@wan
mengetahui	men @@ketahui
nasional	nasional
asuransi	asuransi
berbatasan	ber @@batas @@an
muslim	muslim
menjajakan	men @@jaja @@kan
menempel	men @@tempel
kuku	kuku
tercela	ter @@cela
tampilan	tampil @@an
rata	rata
akurat	akurat
menanggapi	men @@tanggap @@i
semut	semut
merehabilitasi	men @@rehabilitasi
dialihkan	di @@alih @@kan
bertuliskan	ber @@tulis @@kan
granat	granat
komputer	komputer
imannya	iman @@nya
tetapkan	tetap @@kan
harun	harun
preminya	premi @@nya
anggota	anggota
konfirmasi	konfirmasi
berproduksi	ber @@produksi
penakut	pen @@takut
menggenapi	men @@genap @@i
berdoa	ber @@doa
rambutnya	rambut @@nya
jatuhnya	jatuh @@nya
jebakan	jebak @@an
perdata	perdata
embun	embun
identifikasi	identifikasi
jaminannya	jamin @@an @@nya
berupaya	ber @@upaya
kejutan	kejut @@an
pengajuannya	pen @@aju @@an @@nya
penulisan	pen @@tulis @@an
terang	terang
menandaskan	men @@tandas @@kan
dukung	dukung
wakilnya	wakil @@nya
gayanya	gaya @@nya
pengukur	pen @@ukur
jangkauannya	jangkau @@an @@nya
perkampungan	per @@kampung @@an
berkuasa	ber @@kuasa
dengarkan	dengar @@kan
perburuan	per @@buru @@an
kulalui	ku @@lalu @@i
wangi	wangi
berpandangan	ber @@pandang @@an
bangkit	bangkit
bersentuhan	ber @@sentuh @@an
penggemar	pen @@gemar
menyatukan	men @@satu @@kan
pemerannya	pen @@peran @@nya
meminimalkan	men @@minimal @@kan
memilihkan	men @@pilih @@kan
mengulang	men @@ulang
jasa	jasa
sabotase	sabotase
bermaksud	ber @@maksud
doanya	doa @@nya
klasik	klasik
kandidat	kandidat
dipersatukan	di @@per @@satu @@kan
deposito	deposito
dipermasalahkan	di @@per @@masalah @@kan
dilingkupi	di @@lingkup @@i
wawasan	wawasan
menaiki	men @@naik @@i
tersiar	ter @@siar
mengaplikasikan	men @@aplikasi @@kan
volumenya	volume @@nya
nyawa	nyawa
emas	emas
bagikan	bagi @@kan
popularitas	popularitas
penerbitan	pen @@terbit @@an
pangkat	pangkat
pencatatan	pen @@catat @@an
mempertaruhkan	men @@taruh @@kan
datanya	data @@nya
dipecat	di @@pecat
handal	handal
bermartabat	ber @@martabat
mahasiswa	mahasiswa
mencerahkan	men @@cerah @@kan
antarpemilik	antar @@pen @@milik
demo	demo
parsial	parsial
diorganisasi	di @@organisasi
dikuatirkan	di @@kuatir @@kan
pekerjanya	pekerja @@nya
sebaran	sebar @@an
diderita	di @@derita
surgawinya	surgawi @@nya
fungsi	fungsi
sedih	sedih
dampaknya	dampak @@nya
memerankan	men @@peran @@kan
membuktikan	men @@bukti @@kan
ajaranmu	ajar @@an @@mu
ujarnya	ujar @@nya
irlandia	irlandia
balon	balon
lautnya	laut @@nya
mampu	mampu
merelakan	men @@rela @@kan
menggerakkan	men @@gerak @@kan
disalib	di @@salib
pemandu	pen @@pandu
tembakau	tembakau
memberatkan	men @@berat @@kan
merenungkan	men @@renung @@kan
dikategorikan	di @@kategori @@kan
gumuli	gumul @@i
budayanya	budaya @@nya
terhebat	ter @@hebat
bakti	bakti
membanting	men @@banting
berkulit	ber @@kulit
sedarah	se @@darah
keluarga	keluarga
bungkus	bungkus
mendiversifikasi	men @@diversifikasi
antusiasme	antusiasme
berujung	ber @@ujung
rasi	ras @@i
gajian	gaji @@an
kena	kena
memperlambat	men @@lambat
terhutang	ter @@hutang
meliputi	men @@liput @@i
seks	seks
dikukuhkan	di @@kukuh @@kan
dimediasi	di @@mediasi
pengeruk	pen @@keruk
penangguhan	pen @@tangguh @@an
kabarnya	kabar @@nya
mengucapkannya	men @@ucap @@kan @@nya
absensi	absensi
tenda	tenda
perolehannya	peroleh @@an @@nya
muatan	muat @@an
kata	kata
dibenarkan	di @@benar @@kan
duri	duri
perampok	pen @@rampok
gurun	gurun
olahragawan	olahraga @@wan
berhikmat	ber @@hikmat
email	email
tni	tn @@i
bimbang	bimbang
gerutuan	gerutu @@an
mengurai	men @@urai
perujukan	pen @@rujuk @@an
meracuni	men @@racun @@i
diketik	di @@ketik
rangka	rangka
rupanya	rupa @@nya
dikaji	di @@kaji
injil	injil
ditegur	di @@tegur
awalnya	awal @@nya
sahabat	sahabat
diakibatkan	di @@akibat @@kan
diubahnya	di @@ubah @@nya
kaca	kaca
hutang	hutang
bergosip	ber @@gosip
dicirikan	di @@ciri @@kan
menyembunyikan	men @@sembunyi @@kan
menyebrangi	men @@sebrang @@i
prestasi	prestasi
berserikat	ber @@serikat
yayasan	yayasan
inci	inci
diamati	di @@amati
indikasinya	indikasi @@nya
membungkuk	men @@bungkuk
diberatkan	di @@berat @@kan
sukacitanya	sukacita @@nya
tahunan	tahun @@an
anjing	anjing
turnamen	turnamen
menyukseskan	men @@sukses @@kan
hambatannya	hambat @@an @@nya
nyonya	nyonya
terpendam	ter @@pendam
terkejut	ter @@kejut
monitornya	monitor @@nya
instalasi	instalasi
terpasang	ter @@pasang
dorongan	dorong @@an
gereja	gereja
proyeknya	proyek @@nya
musium	musium
kriteria	kriteria
pelantikan	pen @@lantik @@an
tomat	tomat
entri	entri
pukul	pukul
membelanjakan	men @@belanja @@kan
antarpengurus	antar @@pen @@urus
berpribadi	ber @@pribadi
potensial	potensial
diklasifikasi	di @@klasifikasi
menjadikannya	men @@jadi @@kan @@nya
pelelangan	pen @@lelang @@an
tingkatannya	tingkat @@an @@nya
diartikan	di @@arti @@kan
materi	materi
larangan	larang @@an
dituliskan	di @@tulis @@kan
terkelola	ter @@kelola
menindak	men @@tindak
petang	petang
terelakkan	ter @@elak @@kan
abad	abad
pendidik	pen @@didik
pembenci	pen @@benci
puji	puji
jarimu	jari @@mu
melewatkan	men @@lewat @@kan
orangtuaku	orangtua @@aku
demobilisasi	demobilisasi
melebur	men @@lebur
didatangkan	di @@datang @@kan
membiarnya	men @@biar @@nya
strukturnya	struktur @@nya
pundak	pundak
dibabat	di @@babat
berbincang	ber @@bincang
membela	men @@bela
cetakan	cetak @@an
bakatnya	bakat @@nya
merumuskan	men @@rumus @@kan
asosiasi	asosiasi
terima	terima
soda	soda
dililiti	di @@lilit @@i
rasio	rasio
dikapalkan	di @@kapal @@kan
meramalkan	men @@ramal @@kan
cermat	cermat
cerdas	cerdas
ditaklukkan	di @@takluk @@kan
asin	asin
memperhitungkan	men @@hitung @@kan
berlipat	ber @@lipat
liar	liar
bersesuaian	ber @@sesuai @@an
pertanaman	per @@tanam @@an
ketidakefisienan	ke @@tidak @@efisien @@an
tersita	ter @@sita
situasi	situasi
mengkreditnya	men @@kredit @@nya
mesir	mesir
disidangkan	di @@sidang @@kan
bersepakat	ber @@sepakat
dilalui	di @@lalu @@i
tempuh	tempuh
menyusutnya	men @@susut @@nya
rajin	rajin
menaruhnya	men @@taruh @@nya
fotokopi	fotokopi
perdagangan	per @@dagang @@an
organisasinya	organisasi @@nya
bebanmu	beban @@mu
memerdekakan	men @@merdeka @@kan
termutakhir	ter @@mutakhir
kunjungannya	kunjung @@an @@nya
berbakat	ber @@bakat
kerah	kerah
diwajibkan	di @@wajib @@kan
eksploitasi	eksploitasi
hiasan	hias @@an
ketidakjujuran	ke @@tidak @@jujur @@an
peraturannya	per @@atur @@an @@nya
direndahkan	di @@rendah @@kan
ciptaan	cipta @@an
melambat	men @@lambat
kuantitas	kuantitas
antargenerasi	antar @@generasi
jatuhkan	jatuh @@kan
yusuf	yusuf
peserta	peserta
diharapkannya	di @@harap @@kan @@nya
direkrutnya	di @@rekrut @@nya
reksa	reksa
bersinggungan	ber @@singgung @@an
digeluti	di @@gelut @@i
surat	surat
buntu	buntu
keberangkatannya	ke @@berangkat @@an @@nya
raya	raya
gaya	gaya
tobat	tobat
dikelompokkan	di @@kelompok @@kan
peminjam	pen @@pinjam
berwenang	ber @@wenang
dimutakhirkan	di @@mutakhir @@kan
diestimasi	di @@estimasi
dilimpahkan	di @@limpah @@kan
takarannya	takar @@an @@nya
diserahkan	di @@serah @@kan
menyebutnya	men @@sebut @@nya
petugas	petugas
diselidiki	di @@selidik @@i
mengajaknya	men @@ajak @@nya
kaumnya	kaum @@nya
memperebutkan	men @@rebut @@kan
penggagas	pen @@gagas
mawar	mawar
cemburu	cemburu
terabaikan	ter @@abai @@kan
berhenti	ber @@henti
babak	babak
sekunder	sekunder
aspek	aspek
menggelora	men @@gelora
berfirman	ber @@firman
pilihannya	pilih @@an @@nya
piranti	piranti
insentif	insentif
kekalnya	kekal @@nya
penempatan	pen @@tempat @@an
dibalik	di @@balik
transparannya	transparan @@nya
hak	hak
entrinya	entri @@nya
jijik	jijik
bernyanyi	ber @@nyanyi
menciprat	men @@ciprat
penekanan	pen @@tekan @@an
kuadrat	kuadrat
penentuannya	pen @@tentu @@an @@nya
diilhamkan	di @@ilham @@kan
otomotif	otomotif
bentuknya	bentuk @@nya
dimaknai	di @@makna @@i
membolos	men @@bolos
ambisi	ambisi
pisang	pisang
melimpahi	men @@limpah @@i
hulu	hulu
mudahnya	mudah @@nya
inginkan	ingin @@kan
peredaran	per @@edar @@an
berprasangka	ber @@prasangka
direalisasikan	di @@realisasi @@kan
mendirikannya	men @@diri @@kan @@nya
difokuskan	di @@fokus @@kan
makan	makan
catatannya	catat @@an @@nya
noninfrastruktur	non @@infrastruktur
lompatan	lompat @@an
direka	di @@reka
positif	positif
dikasihinya	di @@kasih @@i @@nya
demokrasi	demokrasi
kekasihnya	kekasih @@nya
pembaharuan	pen @@baharu @@an
diagnosa	diagnosa
genggaman	genggam @@an
tajam	tajam
terompet	terompet
lampiran	lampir @@an
surut	surut
pembantu	pen @@bantu
gerak	gerak
jalar	jalar
pakar	pakar
mayat	mayat
berterima	ber @@terima
mencalonkan	men @@calon @@kan
nenek	nenek
ikatan	ikat @@an
fleksibel	fleksibel
samudera	samudera
asistennya	asisten @@nya
bertakhta	ber @@takhta
pendapatannya	pen @@dapat @@an @@nya
penghujat	pen @@hujat
ironisnya	ironis @@nya
menyedihkannya	men @@sedih @@kan @@nya
pangkalan	pangkal @@an
dijumlahkan	di @@jumlah @@kan
gila	gila
kaki	kaki
dibiasakan	di @@biasa @@kan
sebagus	se @@bagus
berdomisili	ber @@domisili
estimasi	estimasi
tersegmentasi	ter @@segmentasi
parkir	parkir
singkatnya	singkat @@nya
tubuhmu	tubuh @@mu
satkernya	satker @@nya
dipungut	di @@pungut
cari	cari
rayakan	raya @@kan
janji	janji
kuliah	kuliah
penggabungan	pen @@gabung @@an
ditulisi	di @@tulis @@i
dipegangnya	di @@pegang @@nya
ambivalen	ambivalen
menanamkan	men @@tanam @@kan
terencana	ter @@rencana
sesaat	se @@saat
pemerintahannya	pen @@perintah @@an @@nya
potong	potong
seintensif	se @@intensif
dibakar	di @@bakar
subkontrak	subkontrak
mempersoalkan	men @@soal @@kan
pertumbuhan	per @@tumbuh @@an
dananya	dana @@nya
grup	grup
serunya	seru @@nya
tekun	tekun
dikhotbahkan	di @@khotbah @@kan
memegangnya	men @@pegang @@nya
mengecam	men @@kecam
sebutkan	sebut @@kan
terparkir	ter @@parkir
peninjauan	pen @@tinjau @@an
menutupi	men @@tutup @@i
penataan	pen @@tata @@an
genggam	genggam
penyaliban	pen @@salib @@an
teriknya	terik @@nya
mabuk	mabuk
dianugerahkan	di @@anugerah @@kan
diusahakannya	di @@usaha @@kan @@nya
menunduk	men @@tunduk
perumusan	pen @@rumus @@an
disediakan	di @@sedia @@kan
berlibur	ber @@libur
bertahun	ber @@tahun
bertenun	ber @@tenun
iblis	iblis
pemeringkatan	pen @@peringkat @@an
memungutnya	men @@pungut @@nya
tangkap	tangkap
liputan	liput @@an
terungkapkan	ter @@ungkap @@kan
diberi	di @@beri
komoditasnya	komoditas @@nya
memperbesar	men @@besar
anggapan	anggap @@an
moral	moral
tuhan	tuhan
mencukupi	men @@cukup @@i
janin	janin
temannya	teman @@nya
provinsi	provinsi
putuskan	putus @@kan
mengajukannya	men @@aju @@kan @@nya
disangka	di @@sangka
murid	murid
tertampung	ter @@tampung
terbukti	ter @@bukti
moneter	moneter
menduplikasi	men @@duplikasi
diberlakukan	di @@ber @@laku @@kan
pesatnya	pesat @@nya
mungil	mungil
menaruh	men @@taruh
didukung	di @@dukung
gangguan	ganggu @@an
kantornya	kantor @@nya
isterinya	isteri @@nya
menopangnya	men @@topang @@nya
mesra	mesra
kerumunan	kerumun @@an
perangkap	pen @@rangkap
diutamakan	di @@utama @@kan
dibangku	di @@bangku
formasi	formasi
sekutunya	sekutu @@nya
nasib	nasib
lantunan	lantun @@an
bergoncang	ber @@goncang
risikonya	risiko @@nya
punah	punah
darahnya	darah @@nya
ketidakadaan	ke @@tidak @@ada @@an
skema	skema
nonkontrak	non @@kontrak
pembeda	pen @@beda
hotelnya	hotel @@nya
menolongnya	men @@tolong @@nya
memperbarui	men @@baru @@i
berdampak	ber @@dampak
cap	cap
girangnya	girang @@nya
pengertiannya	pengertian @@nya
kebagian	ke @@bagi @@an
pengarahannya	pen @@arah @@an @@nya
mendamaikan	men @@damai @@kan
tersisa	ter @@sisa
gugup	gugup
insinyur	insinyur
campur	campur
propinsi	propinsi
menyebabkan	men @@sebab @@kan
memilihnya	men @@pilih @@nya
berdebar	ber @@debar
polanya	pola @@nya
aturannya	atur @@an @@nya
temanmu	teman @@mu
prajurit	prajurit
ditelanjangi	di @@telanjang @@i
bersorak	ber @@sorak
berbeda	ber @@beda
mengungkapkannya	men @@ungkap @@kan @@nya
berkinerja	ber @@kinerja
as	as
menyayangkan	men @@sayang @@kan
menjangkiti	men @@jangkit @@i
batasan	batas @@an
semasa	se @@masa
daftarnya	daftar @@nya
dilembagakan	di @@lembaga @@kan
menyumbang	men @@sumbang
kampusnya	kampus @@nya
berwibawa	ber @@wibawa
antarmasyarakat	antar @@masyarakat
rentan	rentan
tekadnya	tekad @@nya
peluru	peluru
noda	noda
poster	poster
kedatangan	ke @@datang @@an
merosot	merosot
makna	makna
bedah	bedah
belanjanya	belanja @@nya
logam	logam
tuntasnya	tuntas @@nya
pertentangan	per @@tentang @@an
penanaman	pen @@tanam @@an
paruh	paruh
terpancar	ter @@pancar
bercampur	ber @@campur
transformasi	transformasi
mengklasifikasikan	men @@klasifikasi @@kan
penyelesaiannya	pen @@selesai @@an @@nya
rintangan	rintang @@an
seakurat	se @@akurat
terpercaya	ter @@percaya
penjaga	pen @@jaga
berkekurangan	ber @@ke @@kurang @@an
dokumen	dokumen
serap	serap
diagunkan	di @@agun @@kan
harap	harap
tolongku	tolong @@ku
jauh	jauh
sembuh	sembuh
studi	studi
antarkomunitas	antar @@komunitas
ramalannya	ramal @@an @@nya
bergumul	ber @@gumul
penyegelan	pen @@segel @@an
nontarif	non @@tarif
diurus	di @@urus
antarbidang	antar @@bidang
rekan	rekan
variabel	variabel
penyelenggaraan	pen @@selenggara @@an
menemaninya	men @@teman @@i @@nya
membengkak	men @@bengkak
merenovasi	men @@renovasi
ditaruh	di @@taruh
keluh	keluh
mencatat	men @@catat
dirham	dirham
menentangnya	men @@tentang @@nya
akrab	akrab
arab	arab
berkarakteristik	ber @@karakteristik
komputerisasi	komputerisasi
sombong	sombong
menikah	men @@nikah
menggaji	men @@gaji
membentuk	men @@bentuk
eksportir	eksportir
tugas	tugas
terbawa	ter @@bawa
unggun	unggun
dikenali	di @@kenal @@i
ditimpakan	di @@timpa @@kan
bersama	ber @@sama
bapamu	bapa @@mu
insiden	insiden
tombol	tombol
seriusnya	serius @@nya
evaluasinya	evaluasi @@nya
bom	bom
dilatarbelakangi	di @@latarbelakang @@i
mendesaknya	men @@desak @@nya
kaos	kaos
vakum	vakum
perbaikan	per @@baik @@an
injeksikan	injeksi @@kan
menggariskan	men @@garis @@kan
lapar	lapar
nonpersonel	non @@personel
terbaca	ter @@baca
dibentuknya	di @@bentuk @@nya
dipercayakan	di @@percaya @@kan
ketidakakuratan	ke @@tidak @@akurat @@an
berkeramik	ber @@keramik
dihubungi	di @@hubung @@i
berbekal	ber @@bekal
topinya	top @@i @@nya
pengangkatannya	pen @@angkat @@an @@nya
terenggut	ter @@renggut
tersentak	ter @@sentak
bis	bis
sibuk	sibuk
mengkampanyekan	men @@kampanye @@kan
dimasukkannya	di @@masuk @@kan @@nya
sepupu	sepupu
mengikrarkan	men @@ikrar @@kan
perannya	peran @@nya
dinas	dinas
berhemat	ber @@hemat
batu	batu
pengurutan	pen @@urut @@an
lokalnya	lokal @@nya
digadai	di @@gadai
kuno	kuno
dicermati	di @@cermat @@i
terbalik	ter @@balik
sirkuit	sirkuit
pemungut	pen @@pungut
akhirnya	akhir @@nya
kupikir	ku @@pikir
diberkati	di @@berkat @@i
melindungi	men @@lindung @@i
diperkuat	di @@per @@kuat
konteks	konteks
antardesanya	antar @@desa @@nya
mengingatmu	men @@ingat @@mu
dekat	dekat
mewarisi	men @@waris @@i
merahasiakan	men @@rahasia @@kan
mengenakannya	men @@kena @@kan @@nya
pertikaian	pertikaian
terkandung	ter @@kandung
absennya	absen @@nya
terusir	ter @@usir
perkebunan	per @@kebun @@an
induk	induk
kunjungi	kunjung @@i
haknya	hak @@nya
membutuhkan	men @@butuh @@kan
direkonstruksi	di @@rekonstruksi
ruangan	ruang @@an
dihapuskannya	di @@hapus @@kan @@nya
finansial	finansial
bermain	ber @@main
selidiki	selidik @@i
dipaksa	di @@paksa
berurutan	ber @@urut @@an
ketidakpekaan	ke @@tidak @@peka @@an
dikoleksi	di @@koleksi
geografi	geografi
antikristus	anti @@kristus
selusin	se @@lusin
berfluktuasi	ber @@fluktuasi
sepele	sepele
perwakilannya	per @@wakil @@an @@nya
mendengarkannya	men @@dengar @@kan @@nya
penyaluran	pen @@salur @@an
absen	absen
tafsirannya	tafsir @@an @@nya
diangkat	di @@angkat
menggembalakan	men @@gembala @@kan
terkesan	ter @@kesan
bermusyawarah	ber @@musyawarah
meminjamkan	men @@pinjam @@kan
pengkhianatan	pen @@khianat @@an
separuh	se @@paruh
inefisiensi	inefisiensi
tetesan	tetes @@an
sarangnya	sarang @@nya
pendayagunaan	pen @@dayaguna @@an
digunakan	di @@guna @@kan
berlutut	ber @@lutut
dilemparkan	di @@lempar @@kan
menghubungi	men @@hubung @@i
antarnegara	antar @@negara
timur	timur
hektar	hektar
menggolkan	men @@gol @@kan
permulaannya	per @@mula @@an @@nya
dikelolanya	di @@kelola @@nya
dipersembahkan	di @@per @@sembah @@kan
pemeluk	pen @@peluk
semang	semang
rasuli	rasul @@i
menggantikan	men @@ganti @@kan
membocorkan	men @@bocor @@kan
meriamnya	meriam @@nya
politis	politis
berat	berat
mengkompensasi	men @@kompensasi
kudus	kudus
memberitakan	men @@berita @@kan
terdalamnya	ter @@dalam @@nya
beban	beban
bubungan	bubung @@an
gembala	gembala
terlintas	ter @@lintas
kemajuannya	ke @@maju @@an @@nya
kagum	kagum
sekadarnya	se @@kadar @@nya
penelitian	pen @@teliti @@an
eksteriornya	eksterior @@nya
harganya	harga @@nya
tangki	tangki
dimata	di @@mata
mendiami	men @@diam @@i
penyuapan	pen @@suap @@an
menggenggam	men @@genggam
latar	latar
bulannya	bulan @@nya
jangkau	jangkau
belakangan	belakang @@an
dibubarkannya	di @@bubar @@kan @@nya
memicu	men @@picu
mengingkari	men @@ingkar @@i
memperkarakan	men @@perkara @@kan
dipinjamkan	di @@pinjam @@kan
penyelarasan	pen @@selaras @@an
pertambangan	per @@tambang @@an
beredar	ber @@edar
selisih	selisih
stiker	stiker
sampah	sampah
berlangsung	ber @@langsung
ditebus	di @@tebus
menjelaskannya	men @@jelas @@kan @@nya
mendiskriminasi	men @@diskriminasi
menyapanya	men @@sapa @@nya
peningkatannya	pen @@tingkat @@an @@nya
berpacaran	ber @@pacar @@an
perusakan	pen @@rusak @@an
ulang	ulang
ditabungkan	di @@tabung @@kan
membinasakan	men @@binasa @@kan
rasional	rasional
berbelanja	ber @@belanja
paruhnya	paruh @@nya
babakan	babak @@an
berkualitas	ber @@kualitas
diliputi	di @@liput @@i
parah	parah
mengartikan	men @@arti @@kan
dilengkapi	di @@lengkap @@i
upahan	upah @@an
merekam	men @@rekam
kongres	kongres
terkaya	ter @@kaya
liberal	liberal
penggunaan	pen @@guna @@an
relevan	relevan
kelopak	kelopak
rasial	rasial
seabad	se @@abad
secanggih	se @@canggih
penyemprot	pen @@semprot
merumput	men @@rumput
pertandingannya	per @@tanding @@an @@nya
bersemangat	ber @@semangat
pencegahan	pen @@cegah @@an
menghitungnya	men @@hitung @@nya
berhitung	ber @@hitung
pergerakan	per @@gerak @@an
cerdik	cerdik
pemaksaan	pen @@paksa @@an
berkurang	ber @@kurang
telaah	telaah
ditiru	di @@tiru
sendiri	sendiri
kajian	kaji @@an
diijinkan	di @@ijin @@kan
berjanji	ber @@janji
siaran	siar @@an
instruksi	instruksi
berterus	ber @@terus
kumpul	kumpul
menghujat	men @@hujat
sebatas	se @@batas
menghibur	men @@hibur
intim	intim
metrik	metrik
altar	altar
prioritas	prioritas
sahnya	sah @@nya
bapanya	bapa @@nya
stagnan	stagnan
mengajak	men @@ajak
melintas	men @@lintas
simbolis	simbolis
metode	metode
amanat	amanat
diluncurkan	di @@luncur @@kan
tangga	tangga
dilupakan	di @@lupa @@kan
pemakai	pen @@pakai
menyinggung	men @@singgung
memberi	men @@beri
didengarnya	di @@dengar @@nya
daur	daur
ketidakjelasan	ke @@tidak @@jelas @@an
menyelubungi	men @@selubung @@i
hinaan	hina @@an
menamakan	men @@nama @@kan
menyebabkannya	men @@sebab @@kan @@nya
mantan	mantan
penagihan	pen @@tagih @@an
seiring	seiring
tindakan	tindak @@an
nonteknis	nonteknis
keterlibatannya	ke @@terlibat @@an @@nya
terciptanya	ter @@cipta @@nya
duniawi	duniawi
mencocokkannya	men @@cocok @@kan @@nya
terserah	ter @@serah
ketidaksetiaan	ke @@tidak @@setia @@an
membawakan	men @@bawa @@kan
disederhanakan	di @@sederhana @@kan
menyimpulkan	men @@simpul @@kan
mengakomodasi	men @@akomodasi
acuh	acuh
diakhiri	di @@akhir @@i
menelepon	men @@telepon
mengakibatkan	men @@akibat @@kan
diajarkan	di @@ajar @@kan
ditekankan	di @@tekan @@kan
mendewakan	men @@dewa @@kan
implikasi	implikasi
tim	tim
dikasihi	di @@kasih @@i
menggoyang	men @@goyang
pengurus	pen @@urus
berbatu	ber @@batu
bantu	bantu
kejadiannya	ke @@jadi @@an @@nya
tertinggi	ter @@tinggi
marah	marah
memberitahuku	men @@beritahu @@ku
sumber	sumber
rawa	rawa
berkemungkinan	ber @@kemungkinan
fasilitas	fasilitas
diasingkan	di @@asing @@kan
mengusir	men @@usir
populasinya	populasi @@nya
kesediaan	ke @@sedia @@an
gerejanya	gereja @@nya
disalurkan	di @@salur @@kan
membedah	men @@bedah
berbahagia	ber @@bahagia
menghayati	men @@hayat @@i
memperbudak	men @@budak
situsnya	situs @@nya
validasi	validasi
tulis	tulis
pelaporan	pen @@lapor @@an
memutuskan	men @@putus @@kan
mengefektifkan	men @@efektif @@kan
diterapkannya	di @@terap @@kan @@nya
bersejarah	ber @@sejarah
bandara	bandara
badai	badai
terindah	ter @@indah
dianggapnya	di @@anggap @@nya
sisiku	sisi @@ku
disinggung	di @@singgung
lontar	lontar
menjangkau	men @@jangkau
angkatan	angkat @@an
memfasilitasi	men @@fasilitas @@i
peranannya	peran @@an @@nya
gembiranya	gembira @@nya
marinir	marinir
meliput	men @@liput
mengakar	men @@akar
terpuruk	ter @@puruk
kepingan	keping @@an
patung	patung
getaran	getar @@an
menuntun	men @@tuntun
menyaingi	men @@saing @@i
sesuai	sesuai
tagihan	tagih @@an
singapura	singapura
sipil	sipil
memakai	men @@pakai
enggan	enggan
dibutuhkan	di @@butuh @@kan
pala	pala
pesaingnya	pesaing @@nya
dibariskan	di @@baris @@kan
berdetak	ber @@detak
ratifikasi	ratifikasi
berkesusahan	ber @@ke @@susah @@an
antarkomoditas	antar @@komoditas
bangga	bangga
sekeluarga	se @@keluarga
statusnya	status @@nya
sanjungan	sanjung @@an
membatalkan	men @@batal @@kan
diredupkan	di @@redup @@kan
server	server
keraskan	keras @@kan
membuangnya	men @@buang @@nya
perdarahan	per @@darah @@an
menimba	men @@timba
menetesnya	men @@tetes @@nya
diajukannya	di @@aju @@kan @@nya
sanggup	sanggup
menakar	men @@takar
sisinya	sisi @@nya
merintangi	men @@rintang @@i
memamerkan	men @@pamer @@kan
percontohan	per @@contoh @@an
skornya	skor @@nya
berkesudahan	ber @@ke @@sudah @@an
menyenangkan	men @@senang @@kan
dipatok	di @@patok
jarak	jarak
bidikannya	bidik @@an @@nya
puluhan	puluh @@an
mengoper	men @@koper
rumput	rumput
hunian	huni @@an
penunjukkan	penunjukkan
sungkan	sungkan
korupsi	korupsi
regulasi	regulasi
dihormatinya	di @@hormat @@i @@nya
disetujui	di @@setuju @@i
mengentaskan	men @@entas @@kan
diminimalkan	di @@minimal @@kan
terurus	ter @@urus
diyakininya	di @@yakin @@i @@nya
susulan	susul @@an
diteladani	di @@teladan @@i
pengusiran	pen @@usir @@an
melobi	men @@lobi
mencakupi	men @@cakup @@i
aula	aula
berita	berita
rehabilitasinya	rehabilitasi @@nya
danau	danau
berkeyakinan	ber @@ke @@yakin @@an
pengamatannya	pengamat @@an @@nya
lengkap	lengkap
antarorangtua	antar @@orangtua
kehendak	kehendak
perbendaharaan	per @@bendahara @@an
baju	baju
dipajang	di @@pajang
menyajikan	men @@saji @@kan
hambaku	hamba @@aku
taburkan	tabur @@kan
memunculkan	men @@muncul @@kan
binatang	binatang
bersekutu	ber @@sekutu
diperparah	di @@per @@parah
dikompensasikan	di @@kompensasi @@kan
membayarnya	men @@bayar @@nya
posisinya	posisi @@nya
terbenam	ter @@benam
menggosipkan	men @@gosip @@kan
mendistribusi	men @@distribusi
penanda	pen @@tanda
teori	teori
prasarana	prasarana
direncanakan	di @@rencana @@kan
penambak	pen @@tambak
membongkar	men @@bongkar
mengembalikan	men @@kembali @@kan
mekar	mekar
bensin	bensin
mencerna	men @@cerna
stoknya	stok @@nya
tangis	tangis
defensif	defensif
terbelenggu	ter @@belenggu
didalam	di @@dalam
tersingkap	ter @@singkap
didiskualifikasi	di @@diskualifikasi
persebaran	per @@sebar @@an
mencobai	men @@coba @@i
menyalahgunakan	men @@salahguna @@kan
meluap	men @@luap
motivasinya	motivasi @@nya
perumpamaannya	per @@umpama @@an @@nya
memudar	men @@pudar
moyang	moyang
dagangan	dagang @@an
dindingnya	dinding @@nya
berdurasi	ber @@durasi
meningkatkan	men @@tingkat @@kan
dikirimkan	di @@kirim @@kan
menyuburkan	men @@subur @@kan
pengunjuk	pen @@unjuk
memampukan	men @@mampu @@kan
bermerek	ber @@merek
disana	di @@sana
menyerbu	men @@serbu
konservatif	konservatif
pendengarnya	pen @@dengar @@nya
pertengahan	per @@tengah @@an
mobilisasi	mobilisasi
reaksinya	reaksi @@nya
beroperasi	ber @@operasi
dendam	dendam
disemayamkan	di @@semayam @@kan
kontraknya	kontrak @@nya
kriterianya	kriteria @@nya
tercetak	ter @@cetak
terpanjang	ter @@panjang
libur	libur
habitat	habitat
dihibur	di @@hibur
akuratnya	akurat @@nya
juara	juara
cepatnya	cepat @@nya
ditempuh	di @@tempuh
waris	waris
perkataannya	per @@kata @@an @@nya
diandalkan	di @@andal @@kan
tayangan	tayang @@an
memanjakan	men @@manja @@kan
muramku	muram @@ku
dioptimalkan	di @@optimal @@kan
terukir	ter @@ukir
dikaburkan	di @@kabur @@kan
pengasapan	pen @@asap @@an
rute	rute
keinginannya	ke @@ingin @@an @@nya
mencermati	men @@cermat @@i
tertolak	ter @@tolak
perhitungan	per @@hitung @@an
instansinya	instansi @@nya
teladan	teladan
komoditas	komoditas
makro	makro
berlainan	ber @@lain @@an
memvonis	men @@vonis
karun	karun
elemen	elemen
kiranya	kira @@nya
praktek	praktek
khazanah	khazanah
bahasa	bahasa
menular	men @@tular
berjuang	ber @@juang
marjinal	marjinal
warga	warga
penunggakan	pen @@tunggak @@an
memberlakukan	men @@ber @@laku @@kan
berlalunya	ber @@lalu @@nya
terapkan	terap @@kan
november	november
tunggangan	tunggang @@an
curang	curang
kesan	kesan
soalnya	soal @@nya
penutupnya	pen @@tutup @@nya
pengalih	pen @@alih
bersedia	ber @@sedia
sel	sel
leher	leher
ui	ui
web	web
fondasi	fondasi
bertobat	ber @@tobat
bentrokan	bentrok @@an
mereformasi	men @@reformasi
diterbitkan	di @@terbit @@kan
menghadiri	men @@hadir @@i
dinormalkan	di @@normal @@kan
berdampaknya	ber @@dampak @@nya
dikenalnya	di @@kenal @@nya
perantaraan	perantara @@an
teknologi	teknologi
perlengkapannya	per @@lengkap @@an @@nya
kukira	ku @@kira
pemanfaatannya	pen @@manfaat @@an @@nya
jaman	jam @@an
merangkul	men @@rangkul
diredakan	di @@reda @@kan
hambatan	hambat @@an
konstruksi	konstruksi
mulutku	mulut @@ku
terhimpun	ter @@himpun
memanggil	men @@panggil
pergunungan	per @@gunung @@an
pembaca	pen @@baca
bercukur	ber @@cukur
girang	girang
bahtera	bahtera
ketatnya	ketat @@nya
analis	analis
bobot	bobot
kurangi	kurang @@i
alternatifnya	alternatif @@nya
perkawinan	per @@kawin @@an
permen	permen
pemurah	pen @@murah
kreatif	kreatif
penyiarnya	pen @@siar @@nya
moto	moto
memacu	men @@pacu
pembatas	pen @@batas
peluncuran	pen @@luncur @@an
ia	ia
terlindungi	ter @@lindung @@i
pembuka	pen @@buka
kelam	kelam
pemungutannya	pen @@pungut @@an @@nya
pasiennya	pasien @@nya
merangkak	men @@rangkak
membidik	men @@bidik
evolusi	evolusi
memacunya	men @@pacu @@nya
memesan	men @@pesan
kuharap	ku @@harap
direkapitulasi	di @@rekapitulasi
menjalar	men @@jalar
dekade	dekade
jaga	jaga
mencemari	men @@cemar @@i
penghematan	pen @@hemat @@an
tempati	tempat @@i
memerbaiki	men @@perbaiki
positifnya	positif @@nya
ibuku	ibu @@ku
ditindaklanjuti	di @@tindaklanjut @@i
kluster	kluster
tidurnya	tidur @@nya
mentari	mentari
merayu	men @@rayu
langkahnya	langkah @@nya
celah	celah
kembalikan	kembali @@kan
baris	baris
sumur	sumur
tinjauan	tinjau @@an
sutradara	sutradara
putri	putri
jual	jual
kabinet	kabinet
kaku	kaku
transisi	transisi
kadar	kadar
bohong	bohong
berani	berani
strata	strata
bermula	ber @@mula
teguran	tegur @@an
bertiup	ber @@tiup
pengumuman	pen @@umum @@an
didapatkannya	di @@dapat @@kan @@nya
pilihnya	pilih @@nya
berkontribusi	ber @@kontribusi
pembantaian	pen @@bantai @@an
daerah	daerah
perlintasan	per @@lintas @@an
sasarannya	sasar @@an @@nya
kosmetik	kosmetik
mengemban	men @@emban
tercium	ter @@cium
diwujudkan	di @@wujud @@kan
pemantauannya	pen @@pantau @@an @@nya
menantikan	menanti @@kan
puas	puas
layak	layak
ambruk	ambruk
terintimidasi	ter @@intimidasi
mengenalnya	men @@kenal @@nya
memeriksa	men @@periksa
misinya	misi @@nya
popoknya	popok @@nya
managemen	managemen
ditunda	di @@tunda
mencanangkan	men @@canang @@kan
merawat	men @@rawat
dokter	dokter
hadiah	hadiah
sampelnya	sampel @@nya
bertarung	ber @@tarung
membenci	men @@benci
membatasi	men @@batas @@i
keluarganya	keluarga @@nya
terbunuhnya	ter @@bunuh @@nya
advokat	advokat
disisipkan	di @@sisip @@kan
pengharapan	pen @@harap @@an
bubar	bubar
cabang	cabang
alih	alih
arahan	arah @@an
ketidakterbukaan	ke @@tidak @@terbuka @@an
penyederhanaan	pen @@sederhana @@an
saya	saya
didasarkan	di @@dasar @@kan
kapal	kapal
pelatihan	pen @@latih @@an
pemogokan	pen @@mogok @@an
menganggur	men @@anggur
kenalannya	kenal @@an @@nya
menteri	menteri
menghilangkan	men @@hilang @@kan
pelupa	pen @@lupa
merintis	men @@rintis
pencalonan	pen @@calon @@an
tebang	tebang
perkiraan	per @@kira @@an
akibat	akibat
tertuju	ter @@tuju
bawang	bawang
les	les
membayar	men @@bayar
gema	gema
mengharapkannya	men @@harap @@kan @@nya
anjloknya	anjlok @@nya
berpotensi	ber @@potensi
membekaskan	men @@bekas @@kan
tanggap	tanggap
tertawa	ter @@tawa
pemakaian	pen @@pakai @@an
mengembara	men @@kembara
perisai	perisai
susukan	susu @@kan
dimiliki	di @@milik @@i
wisata	wisata
mencicipi	men @@cicip @@i
pernapasan	per @@napas @@an
mendekati	men @@dekat @@i
optimisme	optimisme
ketidaksanggupan	ke @@tidak @@sanggup @@an
melihat	men @@lihat
dibuatnya	di @@buat @@nya
penampilan	pen @@tampil @@an
memaknai	men @@makna @@i
memfoto	men @@foto
malas	malas
saldo	saldo
inisiatif	inisiatif
pinjamannya	pinjam @@an @@nya
persegi	persegi
peliharaannya	pelihara @@an @@nya
brasil	brasil
menyiasatinya	men @@siasat @@i @@nya
dijadikan	di @@jadi @@kan
bidan	bidan
rela	rela
mendua	men @@dua
telingamu	telinga @@mu
robot	robot
ketidaksepakatan	ke @@tidak @@sepakat @@an
sore	sore
antarkuota	antar @@kuota
penyejuk	pen @@sejuk
pemda	pemda
harmonis	harmonis
dinasehati	di @@nasehat @@i
cangkang	cangkang
diremajakan	di @@remaja @@kan
biasa	biasa
persampahan	per @@sampah @@an
motivasi	motivasi
disebutnya	di @@sebut @@nya
pencapaian	pen @@capai @@an
pendosa	pen @@dosa
menyentak	men @@sentak
pesona	pesona
rusaknya	rusak @@nya
kesannya	kesan @@nya
goncangan	goncang @@an
berujar	ber @@ujar
memperlemah	men @@lemah
dilantunkan	di @@lantun @@kan
praktik	praktik
kampanye	kampanye
gembalaku	gembala @@aku
bertingkah	ber @@tingkah
menasehati	men @@nasehat @@i
satuan	satu @@an
dipertahankan	di @@per @@tahan @@kan
imunisasinya	imunisasi @@nya
kupenuhi	ku @@penuh @@i
aktifitas	aktifitas
semprot	semprot
perizinan	per @@izin @@an
permodalan	per @@modal @@an
berpraktik	ber @@praktik
kedudukan	ke @@duduk @@an
pandangannya	pandang @@an @@nya
peristiwa	peristiwa
menamainya	men @@nama @@i @@nya
turunannya	turun @@an @@nya
bersertifikat	ber @@sertifikat
dengar	dengar
geram	geram
penegasan	pen @@tegas @@an
menimpa	men @@timpa
kerabat	kerabat
manajer	manajer
pabrik	pabrik
ditinggalkannya	di @@tinggal @@kan @@nya
konteksnya	konteks @@nya
pemberitahuannya	pen @@beritahu @@an @@nya
wadah	wadah
tujuan	tuju @@an
harum	harum
polos	polos
timbunan	timbun @@an
dibenci	di @@benci
memagari	men @@pagar @@i
rombongan	rombong @@an
penyeleksian	pen @@seleksi @@an
berjarak	ber @@jarak
targetnya	target @@nya
opsi	opsi
bangsa	bangsa
perserikatan	per @@serikat @@an
berimbang	ber @@imbang
merapat	men @@rapat
nopember	nopember
berdenyut	ber @@denyut
pencukur	pen @@cukur
leganya	lega @@nya
disarankan	di @@saran @@kan
kertasnya	kertas @@nya
pelajaran	pelajar @@an
bekerjasama	bekerjasama
penyempitan	pen @@sempit @@an
tandatangani	tandatangan @@i
menunggangi	men @@tunggang @@i
karakter	karakteri
mesjid	mesjid
pembukuan	pen @@buku @@an
memperpendek	men @@pendek
lupakan	lupa @@kan
target	target
memasukan	men @@pasukan
luput	luput
aduan	adu @@an
persaudaraan	per @@saudara @@an
gurunya	guru @@nya
jasanya	jasa @@nya
for	for
kuartal	kuartal
emosionalnya	emosional @@nya
ketidakpastian	ke @@tidak @@pasti @@an
mengokohkan	men @@kokoh @@kan
terjalin	ter @@jalin
berlindung	ber @@lindung
menggerus	men @@gerus
zaman	zaman
kepercayaan	ke @@percaya @@an
atmosfir	atmosfir
luang	luang
berdiri	ber @@diri
pakai	pakai
sarananya	sarana @@nya
polusi	polusi
menggandakan	men @@ganda @@kan
memotivasi	men @@motivasi
dibangunnya	di @@bangun @@nya
menginduk	men @@induk
amarahnya	amarah @@nya
menginvestigasi	men @@investigasi
sana	sana
dibunuh	di @@bunuh
angsa	angsa
cengkeh	cengkeh
peranakan	per @@anak @@an
pergeseran	per @@geser @@an
ketidaksuburan	ke @@tidak @@subur @@an
menitipkan	men @@titip @@kan
difungsikan	di @@fungsi @@kan
apartemen	apartemen
bergejolak	ber @@gejolak
diabaikannya	di @@abai @@kan @@nya
koperasi	koperasi
pangan	pangan
ringkasannya	ringkas @@an @@nya
kampus	kampus
cuacanya	cuaca @@nya
bersenjatakan	ber @@senjata @@kan
dikenakannya	di @@kena @@kan @@nya
diratifikasi	di @@ratifikasi
mempublikasikan	men @@publikasi @@kan
paten	paten
pemanah	pen @@panah
lelang	lelang
perpindahan	per @@pindah @@an
pembidiknya	pen @@bidik @@nya
berharganya	ber @@harga @@nya
ciuman	cium @@an
kamboja	kamboja
bercahaya	ber @@cahaya
tatap	tatap
gali	gali
takuti	takut @@i
dikompensasi	di @@kompensasi
penolakan	pen @@tolak @@an
membalikkan	men @@balik @@kan
gelap	gelap
menyempurnakan	men @@sempurna @@kan
sempit	sempit
mengejar	men @@kejar
memanennya	men @@panen @@nya
pengalengan	pen @@kaleng @@an
jurusan	jurus @@an
bermuara	ber @@muara
terkemuka	ter @@kemuka
panen	panen
gawang	gawang
mengkonfirmasikan	men @@konfirmasi @@kan
pemuka	pen @@muka
nonusaha	non @@usaha
sekehendaknya	se @@kehendak @@nya
nyaman	nyaman
ditekuni	di @@tekun @@i
pengetatan	pen @@ketat @@an
menggembirakan	men @@gembira @@kan
menunggu	men @@tunggu
binasa	binasa
pendengar	pen @@dengar
menghabiskan	men @@habis @@kan
diperlukannya	di @@perlu @@kan @@nya
penyeragaman	pen @@seragam @@an
dibatalkannya	di @@batal @@kan @@nya
keponakan	keponakan
mengirimkannya	men @@kirim @@kan @@nya
menjejakkan	men @@jejak @@kan
kelola	kelola
jarangnya	jarang @@nya
medali	medali
hina	hina
operasinya	operasi @@nya
direktur	direktur
pengungsi	pen @@ungsi
sesuatunya	sesuatu @@nya
suaranya	suara @@nya
polisi	polisi
pertobatannya	per @@tobat @@an @@nya
terwakili	ter @@wakil @@i
bantuan	bantu @@an
jarang	jarang
peraturan	per @@atur @@an
diklaim	di @@klaim
responsnya	respons @@nya
kuadratnya	kuadrat @@nya
pengunjung	pen @@kunjung
menyemangatinya	men @@semangat @@i @@nya
memberiku	men @@beri @@ku
terpenting	ter @@penting
mengucapkan	men @@ucap @@kan
dipandu	di @@pandu
profil	profil
cerah	cerah
ditimbulkan	di @@timbul @@kan
tolak	tolak
kejar	kejar
menangisinya	men @@tangis @@i @@nya
pergumulan	per @@gumul @@an
gubernurnya	gubernur @@nya
menyibak	men @@sibak
disetorkan	di @@setor @@kan
tanya	tanya
menyebutkan	men @@sebut @@kan
manfaatnya	manfaat @@nya
dahsyat	dahsyat
tangkai	tangkai
menjatuhkan	men @@jatuh @@kan
dievaluasi	di @@evaluasi
utangnya	utang @@nya
ratusan	ratus @@an
meyakini	men @@yakin @@i
melayu	melayu
meredakan	men @@reda @@kan
seusia	se @@usia
membanjiri	men @@banjir @@i
mengganggu	men @@ganggu
tangkapannya	tangkap @@an @@nya
kelasnya	kelas @@nya
bukit	bukit
perombakan	pen @@rombak @@an
karat	karat
kehinaan	ke @@hina @@an
menyisihkan	men @@sisih @@kan
penyembahan	pen @@sembah @@an
berskala	ber @@skala
melahirkan	men @@lahir @@kan
menipu	men @@tipu
menyantuni	men @@santun @@i
terkucil	ter @@kucil
pengaduan	pen @@adu @@an
penahanan	pen @@tahan @@an
terlaksana	ter @@laksana
pemanis	pen @@manis
bertunangan	ber @@tunang @@an
pandangnya	pandang @@nya
menyangka	men @@sangka
paksa	paksa
disahkannya	di @@sah @@kan @@nya
pagi	pagi
sedangkan	sedang @@kan
orientasi	orientasi
ramah	ramah
pengintai	pen @@intai
invasi	invasi
mangkuk	mangkuk
urgensi	urgensi
produser	produser
sediakan	sedia @@kan
terhampar	ter @@hampar
medalinya	medali @@nya
penguburan	pen @@kubur @@an
tarif	tarif
menyalin	men @@salin
pendokumentasian	pen @@dokumentasi @@an
sahut	sahut
nuklir	nuklir
kejatuhan	ke @@jatuh @@an
kabupaten	kabupaten
acak	acak
mengeluarkan	men @@keluar @@kan
izinnya	izin @@nya
parlemen	parlemen
membawa	men @@bawa
menanti	menanti
ditambahkan	di @@tambah @@kan
dingin	dingin
tampungnya	tampung @@nya
bangku	bangku
dikejar	di @@kejar
diserap	di @@serap
bertani	ber @@tani
disenangi	di @@senang @@i
unggulan	unggul @@an
independensi	independensi
semangat	semangat
kebangkitan	ke @@bangkit @@an
nyawaku	nyawa @@aku
makmur	makmur
poin	poin
penggandaan	pen @@ganda @@an
warganegaranya	warganegara @@nya
hilangnya	hilang @@nya
mengeram	men @@eram
lurahnya	lurah @@nya
merampas	men @@rampas
mengikat	men @@ikat
pertunjukan	per @@tunjuk @@an
mataku	mata @@aku
kukatakan	ku @@kata @@kan
definisi	definisi
kental	kental
mengenakan	men @@kena @@kan
mengaruniakan	men @@karunia @@kan
abdikan	abdi @@kan
membelakangi	men @@belakang @@i
untung	untung
tuntas	tuntas
diajar	di @@ajar
dominan	dominan
diberitakannya	di @@berita @@kan @@nya
jawaban	jawab @@an
kukenal	ku @@kenal
berkreasi	ber @@kreasi
ditimbang	di @@timbang
pertarungan	per @@tarung @@an
kakek	kakek
berfungsinya	ber @@fungsi @@nya
terdiam	ter @@diam
argumen	argumen
rekening	rekening
timah	timah
sensasi	sensasi
pengalokasiannya	pen @@alokasi @@an @@nya
mengacuhkan	men @@acuh @@kan
taat	taat
antarwaktu	antar @@waktu
personelnya	personel @@nya
gizi	gizi
narkoba	narkoba
mengirimi	men @@kirim @@i
meteran	meter @@an
seraya	se @@raya
dijumpai	di @@jumpa @@i
politiknya	politik @@nya
jalur	jalur
dicetuskan	di @@cetus @@kan
simpulan	simpul @@an
arena	arena
keluhan	keluh @@an
ismail	ismail
dibaharui	di @@baharu @@i
berhimpitan	ber @@himpit @@an
pasaran	pasar @@an
eksekutif	eksekutif
diincar	di @@incar
artistik	artistik
doktor	doktor
mengakomodasikan	men @@akomodasi @@kan
memandangi	men @@pandang @@i
regenerasi	regenerasi
kabar	kabar
debu	debu
meresahkan	men @@resah @@kan
penginjilan	pen @@injil @@an
ditempeli	di @@tempel @@i
administrator	administrator
pemilihan	pen @@pilih @@an
tenaganya	tenaga @@nya
vaksin	vaksin
menyantap	men @@santap
iurannya	iuran @@nya
dirobek	di @@robek
bergirang	ber @@girang
mengikatnya	men @@ikat @@nya
privasinya	privasi @@nya
sesederhana	se @@sederhana
ditargetkan	di @@target @@kan
batang	batang
bermutu	ber @@mutu
menyetujui	men @@setuju @@i
diingatnya	di @@ingat @@nya
cadang	cadang
balai	bala @@i
mengkomunikasikan	men @@komunikasi @@kan
bersalju	ber @@salju
antargereja	antar @@gereja
dilanda	di @@landa
diperdalam	di @@per @@dalam
terpikirkan	ter @@pikir @@kan
perabot	perabot
khas	khas
tentara	tentara
gadis	gadis
melontarkan	men @@lontar @@kan
dihadiahi	di @@hadiah @@i
lulusan	lulus @@an
penghuni	pen @@huni
lewat	lewat
perdananya	perdana @@nya
minyak	minyak
menjejali	men @@jejal @@i
petinju	pen @@tinju
lebar	lebar
1950an	1950 @@an
fasilitasi	fasilitas @@i
pendapatnya	pen @@dapat @@nya
diuraikan	di @@urai @@kan
keheranan	ke @@heran @@an
utusan	utus @@an
amal	amal
alias	alias
membangkitkan	men @@bangkit @@kan
pelacur	pen @@lacur
menggabungkan	men @@gabung @@kan
mengepalai	men @@kepala @@i
menderita	men @@derita
menceritakannya	men @@cerita @@kan @@nya
penyelang	pen @@selang
ragu	ragu
pakaiannya	pakai @@an @@nya
akasia	akasia
perbedaan	per @@beda @@an
menabur	men @@tabur
berdarah	ber @@darah
pemburu	pen @@buru
tertunda	ter @@tunda
menyebar	men @@sebar
belakang	belakang
cakupan	cakup @@an
perangnya	perang @@nya
rontokan	rontok @@an
sekayu	se @@kayu
pakaian	pakai @@an
tangan	tangan
pemikir	pen @@pikir
sikapnya	sikap @@nya
mengabdi	men @@abdi
mengitariku	men @@kitar @@i @@ku
dipahami	di @@paham @@i
neneknya	nenek @@nya
menyalurkan	men @@salur @@kan
miskinnya	miskin @@nya
menghalangimu	men @@halang @@i @@mu
dikagumi	di @@kagum @@i
mengolah	men @@olah
kebutuhanku	ke @@butuh @@an @@ku
diairi	di @@air @@i
menandatangani	men @@tandatangan @@i
dipukul	di @@pukul
deregulasi	deregulasi
milyaran	milyar @@an
suksesi	sukses @@i
unggul	unggul
penghasil	pen @@hasil
dikeluarkannya	di @@keluar @@kan @@nya
ranjang	ranjang
wol	wol
memuat	men @@muat
distribusinya	distribusi @@nya
magnetis	magnetis
nomor	nomor
jurus	jurus
penciumannya	pen @@cium @@an @@nya
traktornya	traktor @@nya
tuannya	tuan @@nya
terkendala	ter @@kendala
pemikirannya	pen @@pikir @@an @@nya
esensi	esens @@i
mengontrakkan	men @@kontrak @@kan
murni	murni
penyinaran	pen @@sinar @@an
sajian	saji @@an
pelabuh	pen @@labuh
resiko	resiko
bangunannya	bangun @@an @@nya
misteri	misteri
bobroknya	bobrok @@nya
membakar	men @@bakar
ketidaktersediaan	ke @@tidak @@tersedia @@an
masyarakat	masyarakat
mengungkap	men @@ungkap
berpengaruh	ber @@pengaruh
bungkusnya	bungkus @@nya
dianggarkan	di @@anggar @@kan
pengaturannya	pen @@atur @@an @@nya
kadonya	kado @@nya
mingguan	minggu @@an
menggandeng	men @@gandeng
tempo	tempo
usah	usah
penderitaannya	pen @@derita @@an @@nya
menyambut	men @@sambut
canggih	canggih
referensi	referensi
jadikan	jadi @@kan
tugasku	tugas @@ku
mengalokasikannya	men @@alokasi @@kan @@nya
meluluskan	men @@lulus @@kan
dikelola	di @@kelola
sebetulnya	se @@betul @@nya
memperkatakan	men @@kata @@kan
olimpiade	olimpiade
menyejukkan	men @@sejuk @@kan
memanggilnya	men @@panggil @@nya
ilahi	ilahi
mengutuknya	men @@kutuk @@nya
sebutan	sebut @@an
merelokasikan	men @@relokasi @@kan
penyelesai	pen @@selesai
pengusahaan	pen @@usaha @@an
kunci	kunci
perekat	pen @@rekat
sabar	sabar
selamat	selamat
mengerti	mengerti
nurani	nurani
pertolongannya	per @@tolong @@an @@nya
setangkai	se @@tangkai
kartunya	kartu @@nya
rawan	rawan
menginjakkan	men @@injak @@kan
ketidakpuasan	ke @@tidak @@puas @@an
dijahitkan	di @@jahit @@kan
air	air
cabai	cabai
bernada	ber @@nada
berminat	ber @@minat
paparan	papar @@an
optimis	optimis
percayanya	percaya @@nya
membosankan	men @@bosan @@kan
meneruskannya	men @@terus @@kan @@nya
transaksi	transaksi
benda	benda
mendinginkan	men @@dingin @@kan
baki	bak @@i
perilakunya	perilaku @@nya
seni	seni
goncangkan	goncang @@kan
permasalahannya	per @@masalah @@an @@nya
curahan	curah @@an
penulis	pen @@tulis
butir	butir
jahe	jahe
warna	warna
dicobai	di @@coba @@i
fakultas	fakultas
perjumpaan	per @@jumpa @@an
diikutsertakan	di @@ikutserta @@kan
pegang	pegang
dinyatakannya	di @@nyata @@kan @@nya
penghilang	pen @@hilang
pembunuh	pen @@bunuh
dijualnya	di @@jual @@nya
tenang	tenang
mengejutkan	men @@kejut @@kan
stabilitas	stabilitas
wilayahnya	wilayah @@nya
persidangan	per @@sidang @@an
beradaptasi	ber @@adaptasi
bulanan	bulan @@an
diperkirakan	di @@per @@kira @@kan
aumannya	aum @@an @@nya
pengaman	pen @@aman
kebunnya	kebun @@nya
berpikir	ber @@pikir
cacing	cacing
kupon	kupon
penyataan	pen @@nyata @@an
menginginkanmu	men @@ingin @@kan @@mu
menerus	men @@terus
sebagian	sebagian
relevansinya	relevansi @@nya
memandang	men @@pandang
goyangkan	goyang @@kan
mengkoordinir	men @@koordinir
dinyanyikan	di @@nyanyi @@kan
dipinjam	di @@pinjam
sebangsamu	se @@bangsa @@mu
gugus	gugus
dijadwalkan	di @@jadwal @@kan
bangkrut	bangkrut
pertanyaannya	per @@tanya @@an @@nya
macam	macam
mendasari	men @@dasar @@i
membuang	men @@buang
lapak	lapak
saksama	saksama
mempraktekkan	men @@praktek @@kan
hartamu	harta @@mu
rekapitulasinya	rekapitulasi @@nya
hatinya	hati @@nya
intensitas	intensitas
manusianya	manusia @@nya
familinya	famili @@nya
menyetujuinya	men @@setuju @@i @@nya
mengosongkannya	men @@kosong @@kan @@nya
membuat	men @@buat
cucu	cucu
bertanggungjawab	ber @@tanggungjawab
puncaknya	puncak @@nya
komunitasnya	komunitas @@nya
gusar	gusar
kasih	kasih
perajin	pen @@rajin
distrik	distrik
sebesar	se @@besar
menangkis	men @@tangkis
disekolahkan	di @@sekolah @@kan
penyatuan	pen @@satu @@an
lontarkan	lontar @@kan
cantik	cantik
memindahkan	men @@pindah @@kan
mencarinya	men @@cari @@nya
luka	luka
antartahun	antar @@tahun
teralih	ter @@alih
pemetikan	pen @@petik @@an
giliran	gilir @@an
menyetor	men @@setor
sekolahnya	sekolah @@nya
pemberantasan	pen @@berantas @@an
diwakilinya	di @@wakil @@i @@nya
masai	masa @@i
mencium	men @@cium
kita	kita
santunan	santun @@an
pajak	pajak
terhalang	ter @@halang
berdatangan	ber @@datang @@an
mengekspor	men @@ekspor
pemasyarakatan	pen @@masyarakat @@an
kaum	kaum
potongan	potong @@an
terkumpul	ter @@kumpul
diloloskan	di @@lolos @@kan
diperbaruinya	di @@per @@baru @@i @@nya
membahu	men @@bahu
cek	cek
galak	galak
teramati	ter @@amati
kecilnya	kecil @@nya
mengingatkan	men @@ingat @@kan
tempatnya	tempat @@nya
pertanggungjawaban	per @@tanggungjawab @@an
tanggungjawab	tanggungjawab
fakir	fakir
pasukan	pasukan
pemalsu	pen @@palsu
dusunnya	dusun @@nya
menorehkan	men @@toreh @@kan
agen	agen
berseberangan	ber @@seberang @@an
hatiku	hati @@ku
antarpemerintahan	antar @@pen @@perintah @@an
penyerangan	pen @@serang @@an
kepalamu	kepala @@mu
diekspor	di @@ekspor
melekatnya	men @@lekat @@nya
mengkhususkan	men @@khusus @@kan
mengklasifikasi	men @@klasifikasi
ditabung	di @@tabung
mencampuri	men @@campur @@i
nutrisi	nutrisi
gelang	gelang
tunduk	tunduk
melonjaknya	men @@lonjak @@nya
merekomendasi	men @@rekomendasi
mengatasi	men @@atas @@i
adanya	ada @@nya
tuna	tuna
kolonial	kolonial
pengerasan	pen @@keras @@an
melumpuhkan	men @@lumpuh @@kan
perolehan	peroleh @@an
pemajuan	pen @@maju @@an
fakta	fakta
dipindahkan	di @@pindah @@kan
melantunkan	men @@lantun @@kan
kebutuhanmu	ke @@butuh @@an @@mu
meluncur	men @@luncur
utuh	utuh
pengemis	pen @@kemis
melimpahnya	men @@limpah @@nya
pungutannya	pungut @@an @@nya
pembangunannya	pen @@bangun @@an @@nya
masyarakatnya	masyarakat @@nya
diusahakan	di @@usaha @@kan
es	es
perkuliahan	per @@kuliah @@an
sukar	sukar
misi	misi
ketidaklayakan	ke @@tidak @@layak @@an
anak	anak
riset	riset
penyanyi	pen @@nyanyi
selesainya	selesai @@nya
sosis	sosis
melengkapi	men @@lengkap @@i
membimbingnya	men @@bimbing @@nya
menyelenggarakannya	men @@selenggara @@kan @@nya
artian	arti @@an
disidang	di @@sidang
memutakhirkan	men @@mutakhir @@kan
wajah	wajah
menetapkannya	men @@tetap @@kan @@nya
penyerapan	pen @@serap @@an
menanyakannya	men @@tanya @@kan @@nya
mendekatkan	men @@dekat @@kan
pertambahan	per @@tambah @@an
mempercepat	men @@cepat
perputaran	per @@putar @@an
indah	indah
mandinya	mandi @@nya
gunting	gunting
dijelang	di @@jelang
vonis	vonis
melukainya	men @@luka @@i @@nya
terhentinya	ter @@henti @@nya
plastik	plastik
sertifikasi	sertifikasi
pengarahan	pen @@arah @@an
dikeluarkan	di @@keluar @@kan
halnya	hal @@nya
tanganmu	tangan @@mu
anonim	anonim
mm	mm
penanggulangan	pen @@tanggulang @@an
editorialnya	editorial @@nya
bentuk	bentuk
potret	potret
menyadarinya	men @@sadar @@i @@nya
terarah	ter @@arah
jasad	jasad
suntikan	suntik @@an
pasal	pasal
cukupi	cukup @@i
menakjubkan	men @@takjub @@kan
obat	obat
wasiat	wasiat
perorangan	per @@orang @@an
kacang	kacang
penggelapan	pen @@gelap @@an
sampingnya	samping @@nya
bapak	bapak
jualbeli	jualbeli
betina	betina
lidahnya	lidah @@nya
penggundulan	pen @@gundul @@an
menelaah	men @@telaah
massal	massal
memikirkan	men @@pikir @@kan
bergelantungan	ber @@gelantung @@an
arti	arti
penayangan	pen @@tayang @@an
memberitahunya	men @@beritahu @@nya
warganya	warga @@nya
menganggukkan	men @@angguk @@kan
dihasilkan	di @@hasil @@kan
produktif	produktif
berlokasi	ber @@lokasi
agroindustri	agroindustri
dimintakan	di @@minta @@kan
menghindarinya	men @@hindar @@i @@nya
terangkum	ter @@rangkum
menipis	men @@tipis
tanamannya	tanam @@an @@nya
menggandakannya	men @@ganda @@kan @@nya
kilang	kilang
berumur	ber @@umur
mengingini	men @@ingin @@i
keruh	keruh
dipresentasikan	di @@presentasi @@kan
perguliran	per @@gulir @@an
tahunannya	tahun @@an @@nya
jerman	jerman
skala	skala
penyelesaian	pen @@selesai @@an
makannya	makan @@nya
kuotanya	kuota @@nya
dipikirnya	di @@pikir @@nya
tegar	tegar
gigih	gigih
tertulis	ter @@tulis
pakunya	paku @@nya
depan	depan
melukiskan	men @@lukis @@kan
pergolakan	per @@golak @@an
dijajakan	di @@jaja @@kan
bergantian	ber @@ganti @@an
fungsinya	fungsi @@nya
gua	gua
personil	personil
berduri	ber @@duri
upacara	upacara
perceraiannya	per @@cerai @@an @@nya
bagusnya	bagus @@nya
menyebarnya	men @@sebar @@nya
ekspresi	ekspresi
diperlunak	di @@per @@lunak
rantai	rantai
selengkap	se @@lengkap
luasnya	luas @@nya
terinspirasi	ter @@inspirasi
kitabnya	kitab @@nya
